chromosome;rs_id;reference;alternate;start;end;type;sv_length
1;;N;DUP;145005471;248836066;CNV;103830595
2;;N;DUP;15831875;16088595;CNV;256720
3;;N;DEL;226440;58277437;CNV;58050997
5;;N;DUP;1287976;181209897;CNV;179921921
11;;N;DEL;91687658;110422687;CNV;18735029
11;;N;DEL;110528066;134695153;CNV;24167087
12;;N;DUP;113046910;133104157;CNV;20057247
13;;N;DEL;19201632;114233448;CNV;95031816
16;;N;DEL;46785045;89958455;CNV;43173410
17;;N;DEL;542062;18385804;CNV;17843742
18;;N;DUP;10000;80080951;CNV;80070951
17;;N;DEL;542062;4235452;CNV;3693390
17;;N;DEL;4721588;18183497;CNV;13461909
17;;N;DUP;18385804;33002034;CNV;14616230
17;;N;DUP;33157303;34756006;CNV;1598703
17;;N;DUP;34909767;82823278;CNV;47913511
2;;N;DEL;88941585;90096305;CNV;1154720
2;;N;DUP;146209734;147860917;CNV;1651183
5;;N;DUP;1287976;3203131;CNV;1915155
5;;N;DUP;172475214;181209897;CNV;8734683
7;;N;DUP;127793;5768739;CNV;5640946
7;;N;DUP;6097060;149216484;CNV;143119424
7;;N;DUP;150416756;159076575;CNV;8659819
8;;N;DEL;627988;144889232;CNV;144261244
11;;N;DEL;232718;134695153;CNV;134462435
14;;N;DUP;20112681;24642353;CNV;4529672
14;;N;DUP;25092798;103764026;CNV;78671228
14;;N;DUP;104689550;106700056;CNV;2010506
17;;N;DEL;542062;18183497;CNV;17641435
17;;N;DUP;18385804;82823278;CNV;64437474
2;;N;DUP;15732491;16088595;CNV;356104
9;;N;DEL;60190;289255;CNV;229065
11;;N;DEL;232718;36783288;CNV;36550570
13;;N;DEL;19201632;53416955;CNV;34215323
17;;N;DUP;19345201;82823278;CNV;63478077
20;;N;DEL;301356;25094626;CNV;24793270
20;;N;DEL;31727627;64290965;CNV;32563338
8;;N;DEL;627988;88228157;CNV;87600169
8;;N;DEL;89925768;144889232;CNV;54963464
11;;N;DEL;67962179;67981793;CNV;19614
13;;N;DEL;39057266;57148383;CNV;18091117
17;;N;DUP;18385804;28736852;CNV;10351048
17;;N;DUP;28894362;29254753;CNV;360391
17;;N;DUP;29340701;31022654;CNV;1681953
17;;N;DUP;31704858;32636782;CNV;931924
17;;N;DUP;33002034;34756006;CNV;1753972
2;;N;DUP;15217667;16693140;CNV;1475473
10;;N;DEL;133136017;133496386;CNV;360369
12;;N;DUP;4115370;9574307;CNV;5458937
12;;N;DUP;26180296;33207819;CNV;7027523
4;;N;DEL;151696803;186735809;CNV;35039006
5;;N;DEL;70326175;70998450;CNV;672275
7;;N;DUP;127793;76808519;CNV;76680726
7;;N;DUP;77121721;159076575;CNV;81954854
14;;N;DUP;53958005;106700056;CNV;52742051
16;;N;DEL;56403069;87705854;CNV;31302785
16;;N;DEL;88100745;89663707;CNV;1562962
16;;N;DEL;89853839;89958455;CNV;104616
20;;N;DEL;301356;11967244;CNV;11665888
7;;N;DUP;127793;159076575;CNV;158948782
8;;N;DEL;627988;42262753;CNV;41634765
8;;N;DEL;42495342;54161165;CNV;11665823
8;;N;DEL;54511015;88228157;CNV;33717142
17;;N;DUP;18385804;31022654;CNV;12636850
17;;N;DUP;31704858;82823278;CNV;51118420
22;;N;DEL;42600283;50668170;CNV;8067887
1;;N;DUP;224629159;248836066;CNV;24206907
8;;N;DEL;627988;29935645;CNV;29307657
11;;N;DEL;232718;76764733;CNV;76532015
11;;N;DEL;78393063;134695153;CNV;56302090
12;;N;DUP;115858103;133104157;CNV;17246054
21;;N;DUP;13250523;46602054;CNV;33351531
5;;N;DEL;171448906;181209897;CNV;9760991
8;;N;DEL;627988;2512902;CNV;1884914
8;;N;DEL;7397630;8067073;CNV;669443
10;;N;DEL;276401;133496386;CNV;133219985
11;;N;DEL;81983908;108345792;CNV;26361884
11;;N;DEL;108399210;126306031;CNV;17906821
16;;N;DUP;112177;1797708;CNV;1685531
16;;N;DUP;2177531;3637665;CNV;1460134
16;;N;DEL;57664029;89958455;CNV;32294426
20;;N;DEL;301356;64290965;CNV;63989609
1;;N;DEL;16534512;16740130;CNV;205618
10;;N;DEL;132621221;133496386;CNV;875165
16;;N;DEL;112177;2177531;CNV;2065354
17;;N;DEL;542062;816670;CNV;274608
17;;N;DEL;943954;4235452;CNV;3291498
17;;N;DEL;4721588;6962527;CNV;2240939
17;;N;DEL;7134583;7930622;CNV;796039
17;;N;DEL;8074725;18183497;CNV;10108772
17;;N;DUP;18385804;32636782;CNV;14250978
17;;N;DUP;33002034;35039632;CNV;2037598
17;;N;DUP;35140907;35816728;CNV;675821
17;;N;DUP;36036922;37419130;CNV;1382208
17;;N;DUP;37636960;82823278;CNV;45186318
1;;N;DEL;119859449;148308494;CNV;28449045
2;;N;DUP;10000;14760427;CNV;14750427
2;;N;DUP;14997130;23699713;CNV;8702583
2;;N;DUP;24131149;169302293;CNV;145171144
3;;N;DUP;97418020;197948565;CNV;100530545
8;;N;DEL;24460765;88228157;CNV;63767392
8;;N;DUP;90018071;98209551;CNV;8191480
8;;N;DEL;99885479;116475431;CNV;16589952
10;;N;DEL;100711429;133496386;CNV;32784957
15;;N;DUP;48294219;65083295;CNV;16789076
15;;N;DUP;65893824;101610799;CNV;35716975
16;;N;DEL;46785045;81342925;CNV;34557880
17;;N;DEL;4721588;20327260;CNV;15605672
17;;N;DEL;33002034;35039632;CNV;2037598
17;;N;DEL;35140907;46738866;CNV;11597959
17;;N;DUP;46745527;82823278;CNV;36077751
20;;N;DEL;37411897;39532121;CNV;2120224
20;;N;DEL;64184898;64290965;CNV;106067
22;;N;DUP;21670783;42803460;CNV;21132677
2;;N;DEL;10000;241977405;CNV;241967405
4;;N;DUP;147628;4218530;CNV;4070902
4;;N;DUP;4880719;48907148;CNV;44026429
4;;N;DUP;51882912;90698619;CNV;38815707
4;;N;DUP;176356698;189821263;CNV;13464565
11;;N;DEL;232718;66681125;CNV;66448407
11;;N;DEL;66947285;77094064;CNV;10146779
14;;N;DEL;20112681;106700056;CNV;86587375
17;;N;DEL;4721588;5351578;CNV;629990
17;;N;DEL;5575439;18183497;CNV;12608058
11;;N;DEL;232718;50181895;CNV;49949177
17;;N;DEL;4721588;5326393;CNV;604805
17;;N;DEL;5351578;18183497;CNV;12831919
1;;N;DUP;189140386;248836066;CNV;59695680
2;;N;DUP;15974229;16448610;CNV;474381
3;;N;DEL;226440;89476449;CNV;89250009
10;;N;DEL;44129084;102838827;CNV;58709743
10;;N;DEL;103627895;133496181;CNV;29868286
12;;N;DUP;41516476;132859309;CNV;91342833
16;;N;DEL;56403069;89958455;CNV;33555386
17;;N;DEL;4721588;17585769;CNV;12864181
17;;N;DUP;18385804;28472728;CNV;10086924
17;;N;DUP;28736852;29340701;CNV;603849
17;;N;DUP;29468287;82823278;CNV;53354991
21;;N;DUP;13250523;40336904;CNV;27086381
5;;N;DUP;136280427;153677981;CNV;17397554
6;;N;DUP;32432758;32554644;CNV;121886
9;;N;DEL;85443497;86182991;CNV;739494
17;;N;DEL;5351578;18385804;CNV;13034226
1;;N;DUP;161654302;161738742;CNV;84440
5;;N;DUP;70326175;70998450;CNV;672275
7;;N;DUP;74762183;159076575;CNV;84314392
8;;N;DEL;89925768;141234631;CNV;51308863
8;;N;DEL;141437218;144889232;CNV;3452014
13;;N;DEL;33396933;114233448;CNV;80836515
17;;N;DEL;4721588;16264562;CNV;11542974
17;;N;DUP;16778727;82823278;CNV;66044551
2;;N;DEL;16296162;40355713;CNV;24059551
6;;N;DUP;159154495;170592082;CNV;11437587
12;;N;DUP;115555071;133104157;CNV;17549086
16;;N;DEL;47934513;89958455;CNV;42023942
17;;N;DEL;4721588;14520837;CNV;9799249
17;;N;DUP;15571709;58782870;CNV;43211161
17;;N;DUP;58926790;62523977;CNV;3597187
17;;N;DUP;62719505;82823278;CNV;20103773
1;;N;DEL;150857582;151009855;CNV;152273
2;;N;DUP;680946;71114135;CNV;70433189
8;;N;DEL;42495342;47984217;CNV;5488875
8;;N;DEL;48380067;54161165;CNV;5781098
8;;N;DEL;54511015;71308140;CNV;16797125
8;;N;DEL;71609133;88228157;CNV;16619024
10;;N;DEL;75452431;102838827;CNV;27386396
10;;N;DEL;103627895;133496386;CNV;29868491
17;;N;DEL;542062;943954;CNV;401892
17;;N;DEL;1055064;3671971;CNV;2616907
17;;N;DEL;3901198;4235452;CNV;334254
17;;N;DUP;32015035;82823278;CNV;50808243
1;;N;DUP;171963874;184576451;CNV;12612577
1;;N;DUP;196698020;223007035;CNV;26309015
1;;N;DUP;223203701;224590297;CNV;1386596
2;;N;DEL;211382572;241977405;CNV;30594833
4;;N;DEL;147628;189821263;CNV;189673635
5;;N;DUP;1287976;68256032;CNV;66968056
5;;N;DUP;72410034;181209897;CNV;108799863
8;;N;DUP;627988;126779692;CNV;126151704
8;;N;DUP;126956692;128317813;CNV;1361121
10;;N;DUP;126796940;126887853;CNV;90913
16;;N;DEL;112177;87705854;CNV;87593677
17;;N;DUP;21259129;82823278;CNV;61564149
21;;N;DEL;13250523;46602054;CNV;33351531
22;;N;DEL;21670783;50668170;CNV;28997387
11;;N;DUP;77896460;77908851;CNV;12391
17;;N;DUP;18385804;29340701;CNV;10954897
17;;N;DUP;29468287;31514163;CNV;2045876
17;;N;DUP;31704858;58782870;CNV;27078012
4;;N;DUP;147628;189821263;CNV;189673635
5;;N;DUP;129996295;181209897;CNV;51213602
8;;N;DEL;627988;5547720;CNV;4919732
8;;N;DEL;6058314;8209541;CNV;2151227
8;;N;DEL;8314437;24460765;CNV;16146328
8;;N;DUP;117076953;119403723;CNV;2326770
8;;N;DUP;123290050;126145684;CNV;2855634
8;;N;DUP;126303273;126956692;CNV;653419
8;;N;DUP;127111008;127728775;CNV;617767
17;;N;DEL;4335175;5326393;CNV;991218
17;;N;DUP;27761521;82823278;CNV;55061757
8;;N;DUP;66186748;66576091;CNV;389343
17;;N;DEL;4721588;18385804;CNV;13664216
17;;N;DUP;19345201;29340701;CNV;9995500
17;;N;DUP;32015035;32636782;CNV;621747
17;;N;DUP;33002034;34909767;CNV;1907733
17;;N;DUP;35039632;82823278;CNV;47783646
1;;N;DUP;46607841;46635455;CNV;27614
1;;N;DUP;147037627;248917362;CNV;101879735
6;;N;DEL;43181419;141581714;CNV;98400295
11;;N;DUP;77616359;102836715;CNV;25220356
16;;N;DEL;74408911;74414454;CNV;5543
17;;N;DUP;183950;5533956;CNV;5350006
17;;N;DUP;41524969;41549940;CNV;24971
22;;N;DEL;24414569;32368526;CNV;7953957
22;;N;DEL;41906106;43283627;CNV;1377521
22;;N;DEL;47411337;49415793;CNV;2004456
1;;N;DUP;148893279;182598993;CNV;33705714
1;;N;DUP;182614109;182616536;CNV;2427
1;;N;DUP;182641957;248917362;CNV;66275405
2;;N;DUP;85695995;85713156;CNV;17161
3;;N;DUP;38483341;38491312;CNV;7971
5;;N;DUP;36606693;36668891;CNV;62198
5;;N;DUP;77073914;77076815;CNV;2901
6;;N;DUP;29552992;29791288;CNV;238296
6;;N;DUP;36391015;36488917;CNV;97902
7;;N;DUP;104831006;105013597;CNV;182591
11;;N;DUP;115180893;115201041;CNV;20148
16;;N;DUP;53602083;53643443;CNV;41360
18;;N;DUP;9954604;10038374;CNV;83770
19;;N;DUP;8575539;8697470;CNV;121931
20;;N;DUP;96331;13772553;CNV;13676222
20;;N;DUP;13816911;13995078;CNV;178167
20;;N;DUP;14053464;64265396;CNV;50211932
22;;N;DUP;45689770;45921511;CNV;231741
1;;N;DUP;36795677;37716356;CNV;920679
1;;N;DEL;37760566;37864381;CNV;103815
3;;N;DEL;141738450;141818142;CNV;79692
4;;N;DEL;189940948;190089947;CNV;148999
9;;N;DUP;124259448;125745791;CNV;1486343
9;;N;DUP;125904417;127393422;CNV;1489005
9;;N;DUP;127407485;128061448;CNV;653963
11;;N;DEL;47164784;47415336;CNV;250552
11;;N;DUP;77122669;78436765;CNV;1314096
14;;N;DUP;19271020;21116506;CNV;1845486
15;;N;DUP;20360761;23686464;CNV;3325703
15;;N;DUP;24165125;27527962;CNV;3362837
17;;N;DUP;36495340;39248264;CNV;2752924
17;;N;DUP;39258015;39567174;CNV;309159
17;;N;DUP;39605638;40195583;CNV;589945
19;;N;DUP;38252944;38283661;CNV;30717
1;;N;DUP;242089009;248917362;CNV;6828353
8;;N;DUP;74854447;145053383;CNV;70198936
15;;N;DUP;85226915;101654591;CNV;16427676
11;;N;DUP;27907760;27987717;CNV;79957
11;;N;DUP;69090483;70864494;CNV;1774011
20;;N;DUP;16041242;16551742;CNV;510500
20;;N;DUP;17735799;19757072;CNV;2021273
20;;N;DUP;22400976;25989696;CNV;3588720
3;;N;DEL;100016152;100181379;CNV;165227
8;;N;DUP;7712897;7896517;CNV;183620
8;;N;DUP;17655937;17868605;CNV;212668
15;;N;DUP;72206764;72685865;CNV;479101
15;;N;DUP;73559819;73591996;CNV;32177
16;;N;DEL;30739288;30992403;CNV;253115
17;;N;DUP;19297112;19651742;CNV;354630
17;;N;DUP;27312332;34639228;CNV;7326896
17;;N;DUP;35858288;35922645;CNV;64357
17;;N;DUP;36940486;37087353;CNV;146867
17;;N;DUP;38177460;40016593;CNV;1839133
17;;N;DUP;40026233;41139584;CNV;1113351
17;;N;DUP;41149107;41315308;CNV;166201
17;;N;DUP;41627396;41691319;CNV;63923
17;;N;DUP;45265229;45435933;CNV;170704
17;;N;DUP;46196583;46544178;CNV;347595
17;;N;DUP;64880050;64893103;CNV;13053
21;;N;DUP;42313549;42362345;CNV;48796
1;;N;DUP;16467691;16703025;CNV;235334
1;;N;DUP;111454274;111547452;CNV;93178
1;;N;DUP;144017529;248917362;CNV;104899833
5;;N;DEL;70867807;71111518;CNV;243711
6;;N;DUP;16429858;24650171;CNV;8220313
6;;N;DUP;24667844;26096505;CNV;1428661
6;;N;DUP;26104099;26270969;CNV;166870
6;;N;DUP;26272669;26687697;CNV;415028
6;;N;DUP;27023317;27255059;CNV;231742
6;;N;DUP;93410644;99614932;CNV;6204288
7;;N;DUP;128400143;128769166;CNV;369023
8;;N;DEL;67264;47258823;CNV;47191559
8;;N;DUP;51902085;109968169;CNV;58066084
8;;N;DUP;118069787;133043138;CNV;14973351
8;;N;DUP;133237842;145053383;CNV;11815541
9;;N;DUP;29687;10195514;CNV;10165827
9;;N;DUP;33179397;62908810;CNV;29729413
14;;N;DUP;104180803;105499199;CNV;1318396
15;;N;DEL;20360761;21992896;CNV;1632135
16;;N;DEL;33094984;35153323;CNV;2058339
17;;N;DUP;39211713;40171075;CNV;959362
17;;N;DUP;48465984;49404121;CNV;938137
17;;N;DUP;50363273;56594656;CNV;6231383
17;;N;DUP;57409681;57601003;CNV;191322
17;;N;DUP;59602563;60043342;CNV;440779
17;;N;DUP;62387141;65114464;CNV;2727323
17;;N;DUP;76471141;76489768;CNV;18627
1;;N;DEL;202521109;202530176;CNV;9067
8;;N;DUP;12393317;12414878;CNV;21561
16;;N;DUP;23587289;23603639;CNV;16350
16;;N;DUP;82071024;82727524;CNV;656500
17;;N;DEL;19142124;19219736;CNV;77612
19;;N;DUP;41018255;41426120;CNV;407865
8;;N;DEL;67264;41262472;CNV;41195208
15;;N;DEL;28289572;28657087;CNV;367515
16;;N;DEL;33094984;56567780;CNV;23472796
16;;N;DEL;56729676;74338864;CNV;17609188
16;;N;DEL;74419293;87724415;CNV;13305122
16;;N;DEL;88440127;90171823;CNV;1731696
1;;N;DEL;113107718;113229092;CNV;121374
1;;N;DEL;114397764;117963846;CNV;3566082
3;;N;DEL;15971678;93884766;CNV;77913088
3;;N;DUP;94015026;117992879;CNV;23977853
3;;N;DUP;196323791;198038635;CNV;1714844
4;;N;DEL;51868671;67431548;CNV;15562877
4;;N;DUP;70234159;72309426;CNV;2075267
4;;N;DUP;73056459;73743449;CNV;686990
4;;N;DUP;73837795;77066372;CNV;3228577
4;;N;DUP;88707922;88946639;CNV;238717
4;;N;DUP;95335589;102634921;CNV;7299332
4;;N;DUP;128122079;129118267;CNV;996188
4;;N;DEL;129724729;130901735;CNV;1177006
5;;N;DEL;50396509;134439682;CNV;84043173
6;;N;DUP;40382761;57909326;CNV;17526565
7;;N;DEL;76328496;76433582;CNV;105086
8;;N;DUP;67264;111484;CNV;44220
8;;N;DUP;46260814;50016977;CNV;3756163
8;;N;DUP;53226050;72751584;CNV;19525534
8;;N;DUP;72938075;145053383;CNV;72115308
12;;N;DEL;100026709;107319424;CNV;7292715
12;;N;DEL;109448049;112225121;CNV;2777072
12;;N;DUP;128707783;130367226;CNV;1659443
13;;N;DUP;28678152;46895726;CNV;18217574
13;;N;DUP;51591935;52642435;CNV;1050500
14;;N;DUP;105587594;105767877;CNV;180283
15;;N;DEL;20360761;22015301;CNV;1654540
15;;N;DEL;25346024;32743996;CNV;7397972
19;;N;DUP;27776105;28492531;CNV;716426
19;;N;DUP;51173236;51746199;CNV;572963
19;;N;DUP;51769745;55087702;CNV;3317957
2;;N;DEL;241915498;242088078;CNV;172580
3;;N;DUP;195694980;195963190;CNV;268210
5;;N;DUP;184359;50396509;CNV;50212150
10;;N;DEL;86810539;88606739;CNV;1796200
11;;N;DEL;27891076;27907760;CNV;16684
15;;N;DUP;20360761;21992896;CNV;1632135
19;;N;DUP;45296635;45306825;CNV;10190
1;;N;DUP;16426;631735;CNV;615309
1;;N;DUP;1641765;1738992;CNV;97227
5;;N;DEL;71027820;71111518;CNV;83698
7;;N;DUP;99297929;99358369;CNV;60440
8;;N;DUP;35255350;38326808;CNV;3071458
12;;N;DEL;126745189;129071984;CNV;2326795
14;;N;DUP;44504500;53951979;CNV;9447479
19;;N;DEL;22966118;23113776;CNV;147658
1;;N;DEL;913921;6589188;CNV;5675267
1;;N;DEL;149851106;149900608;CNV;49502
5;;N;DEL;184359;1185676;CNV;1001317
5;;N;DEL;7851407;8445237;CNV;593830
5;;N;DUP;37514710;37726982;CNV;212272
5;;N;DEL;68322878;71111518;CNV;2788640
6;;N;DEL;27388916;27893459;CNV;504543
7;;N;DEL;766917;2259075;CNV;1492158
7;;N;DUP;7238370;27121958;CNV;19883588
7;;N;DEL;27130164;27245178;CNV;115014
7;;N;DUP;27412265;43628361;CNV;16216096
7;;N;DEL;44884509;45719317;CNV;834808
7;;N;DEL;55773420;56101830;CNV;328410
7;;N;DUP;77103220;97858897;CNV;20755677
8;;N;DEL;139728321;145053383;CNV;5325062
9;;N;DEL;126505473;138122002;CNV;11616529
10;;N;DEL;132184631;133555381;CNV;1370750
11;;N;DEL;199994;3745423;CNV;3545429
12;;N;DEL;109534764;111361914;CNV;1827150
14;;N;DEL;102500053;106504425;CNV;4004372
15;;N;DEL;73704232;75900118;CNV;2195886
16;;N;DEL;24439;4882235;CNV;4857796
16;;N;DEL;29595549;46729093;CNV;17133544
16;;N;DUP;46803022;49518178;CNV;2715156
16;;N;DEL;49635749;90171823;CNV;40536074
17;;N;DEL;183950;19132709;CNV;18948759
17;;N;DUP;41046754;41315308;CNV;268554
19;;N;DEL;288125;19786709;CNV;19498584
19;;N;DUP;43835535;44662208;CNV;826673
19;;N;DUP;56277613;57908416;CNV;1630803
20;;N;DEL;96331;6528224;CNV;6431893
20;;N;DEL;61933028;64265396;CNV;2332368
22;;N;DEL;15813422;50767910;CNV;34954488
5;;N;DEL;14610430;16474831;CNV;1864401
5;;N;DEL;71027820;71095694;CNV;67874
7;;N;DUP;135674736;141014588;CNV;5339852
8;;N;DEL;67264;6936064;CNV;6868800
8;;N;DEL;7007236;7016026;CNV;8790
8;;N;DEL;7016759;35794423;CNV;28777664
8;;N;DUP;36452849;37844104;CNV;1391255
8;;N;DUP;38210180;50655921;CNV;12445741
8;;N;DUP;50704662;56445849;CNV;5741187
8;;N;DUP;56496282;58102625;CNV;1606343
8;;N;DUP;58147528;67746061;CNV;9598533
8;;N;DUP;67954510;68787479;CNV;832969
8;;N;DUP;68912381;70637450;CNV;1725069
8;;N;DUP;70669476;85135878;CNV;14466402
8;;N;DUP;85176863;86939651;CNV;1762788
8;;N;DUP;87566601;89757170;CNV;2190569
8;;N;DUP;89790153;90051709;CNV;261556
8;;N;DUP;90060221;119423050;CNV;29362829
8;;N;DUP;119619274;123787703;CNV;4168429
8;;N;DUP;123814613;124553091;CNV;738478
8;;N;DUP;124606572;130595523;CNV;5988951
8;;N;DUP;130814133;145053383;CNV;14239250
13;;N;DUP;19173813;36312435;CNV;17138622
15;;N;DUP;88459747;88905849;CNV;446102
15;;N;DUP;89113780;90088653;CNV;974873
15;;N;DUP;90228202;97537565;CNV;7309363
15;;N;DUP;100629956;101654591;CNV;1024635
17;;N;DUP;27078631;29645242;CNV;2566611
18;;N;DEL;3597310;4425372;CNV;828062
18;;N;DEL;20980396;48252689;CNV;27272293
18;;N;DEL;51031149;80184101;CNV;29152952
20;;N;DUP;96331;16378885;CNV;16282554
20;;N;DUP;16551742;20389797;CNV;3838055
20;;N;DUP;26187373;32743797;CNV;6556424
20;;N;DUP;34426291;38581263;CNV;4154972
20;;N;DUP;44964060;57408888;CNV;12444828
20;;N;DUP;57497582;59325926;CNV;1828344
20;;N;DUP;59818623;61988235;CNV;2169612
20;;N;DUP;63628334;64265396;CNV;637062
21;;N;DUP;41798401;44297774;CNV;2499373
8;;N;DUP;7712897;7881410;CNV;168513
11;;N;DUP;57235892;57376874;CNV;140982
16;;N;DUP;90106509;90171823;CNV;65314
22;;N;DUP;23894874;23974335;CNV;79461
4;;N;DUP;56626014;57106391;CNV;480377
4;;N;DEL;76174210;110617538;CNV;34443328
4;;N;DEL;117084566;119551921;CNV;2467355
4;;N;DEL;148292655;190089947;CNV;41797292
6;;N;DUP;52236930;52905825;CNV;668895
6;;N;DUP;52922234;57169437;CNV;4247203
6;;N;DUP;105281491;106787385;CNV;1505894
7;;N;DUP;102474390;102678631;CNV;204241
8;;N;DEL;7841204;7934441;CNV;93237
8;;N;DUP;96610273;100140983;CNV;3530710
8;;N;DUP;100151385;100719672;CNV;568287
8;;N;DUP;100913573;117837170;CNV;16923597
8;;N;DUP;126553106;127416578;CNV;863472
8;;N;DUP;131993493;138588536;CNV;6595043
11;;N;DEL;199994;15081920;CNV;14881926
11;;N;DEL;20367224;22282149;CNV;1914925
11;;N;DUP;22378149;25080667;CNV;2702518
11;;N;DEL;26504012;26994939;CNV;490927
11;;N;DUP;65655900;65789405;CNV;133505
11;;N;DUP;66416865;70064823;CNV;3647958
11;;N;DEL;70187821;134480876;CNV;64293055
12;;N;DUP;566024;819642;CNV;253618
12;;N;DEL;3593911;29668941;CNV;26075030
13;;N;DEL;18906528;114325399;CNV;95418871
15;;N;DEL;22015301;26612463;CNV;4597162
15;;N;DUP;26948265;27951862;CNV;1003597
15;;N;DEL;28111811;40767340;CNV;12655529
15;;N;DUP;40773808;44410548;CNV;3636740
15;;N;DEL;44525382;47773413;CNV;3248031
15;;N;DUP;48135133;48742022;CNV;606889
15;;N;DUP;50289626;50742786;CNV;453160
15;;N;DEL;55171775;56631547;CNV;1459772
15;;N;DEL;61605065;68812298;CNV;7207233
15;;N;DUP;69049002;71110557;CNV;2061555
15;;N;DUP;71294595;71689069;CNV;394474
15;;N;DUP;75914174;77224665;CNV;1310491
15;;N;DEL;77239759;88586826;CNV;11347067
15;;N;DUP;88632149;90074831;CNV;1442682
15;;N;DUP;90088653;92619245;CNV;2530592
15;;N;DUP;92780444;96363983;CNV;3583539
15;;N;DUP;96785550;98762071;CNV;1976521
17;;N;DUP;7290471;7357057;CNV;66586
17;;N;DUP;27312332;29645242;CNV;2332910
17;;N;DUP;32488424;34962515;CNV;2474091
17;;N;DEL;34986064;35131401;CNV;145337
17;;N;DUP;35186509;35725383;CNV;538874
17;;N;DUP;35740475;35937799;CNV;197324
17;;N;DUP;35977565;36608765;CNV;631200
17;;N;DUP;36940486;38402192;CNV;1461706
17;;N;DUP;39653719;40225627;CNV;571908
17;;N;DUP;40278375;40697542;CNV;419167
17;;N;DUP;40835033;41160186;CNV;325153
17;;N;DEL;66415008;78674301;CNV;12259293
20;;N;DUP;51832065;54219569;CNV;2387504
1;;N;DEL;16426;16467691;CNV;16451265
1;;N;DEL;16535127;16703025;CNV;167898
1;;N;DEL;16704111;20482602;CNV;3778491
2;;N;DUP;39143;3497989;CNV;3458846
2;;N;DUP;3532213;78413146;CNV;74880933
3;;N;DUP;7578890;40532084;CNV;32953194
4;;N;DEL;30724508;41534784;CNV;10810276
4;;N;DEL;184312118;190089947;CNV;5777829
5;;N;DEL;184359;662112;CNV;477753
5;;N;DEL;720408;763549;CNV;43141
5;;N;DEL;3610901;14429977;CNV;10819076
5;;N;DEL;14495470;37121750;CNV;22626280
5;;N;DEL;44302848;181275946;CNV;136973098
6;;N;DUP;13230083;26021991;CNV;12791908
6;;N;DUP;26026932;26878209;CNV;851277
6;;N;DEL;26904374;26963417;CNV;59043
6;;N;DUP;27023317;28326073;CNV;1302756
6;;N;DUP;28366587;35833796;CNV;7467209
6;;N;DUP;65787912;93410644;CNV;27622732
6;;N;DUP;117549187;138447098;CNV;20897911
6;;N;DEL;138697012;170577603;CNV;31880591
8;;N;DEL;67264;14878490;CNV;14811226
8;;N;DUP;115412949;138151231;CNV;22738282
10;;N;DUP;37346872;42103941;CNV;4757069
10;;N;DUP;48976831;49612475;CNV;635644
10;;N;DUP;55945993;60029615;CNV;4083622
10;;N;DUP;60054665;61686103;CNV;1631438
10;;N;DUP;118594265;125226322;CNV;6632057
10;;N;DUP;125578380;133555381;CNV;7977001
11;;N;DUP;17796271;18934468;CNV;1138197
11;;N;DUP;25080667;36120345;CNV;11039678
11;;N;DUP;77609468;103091825;CNV;25482357
12;;N;DUP;67329;4352922;CNV;4285593
15;;N;DEL;22015301;42409965;CNV;20394664
15;;N;DUP;42413168;42529734;CNV;116566
16;;N;DUP;6379639;22610699;CNV;16231060
17;;N;DEL;7669041;7673288;CNV;4247
17;;N;DEL;9243378;14208205;CNV;4964827
17;;N;DUP;72041084;73790144;CNV;1749060
18;;N;DEL;68697964;78140620;CNV;9442656
19;;N;DEL;12188622;12349597;CNV;160975
19;;N;DEL;19679803;35747415;CNV;16067612
21;;N;DEL;10605620;46654410;CNV;36048790
1;;N;DUP;60940403;62155566;CNV;1215163
1;;N;DEL;202521109;202554849;CNV;33740
3;;N;DEL;77646108;88141836;CNV;10495728
3;;N;DUP;98981324;100492797;CNV;1511473
3;;N;DUP;133333852;139124499;CNV;5790647
3;;N;DUP;193243440;198038635;CNV;4795195
5;;N;DEL;64804356;66179123;CNV;1374767
6;;N;DEL;26904374;27357864;CNV;453490
7;;N;DEL;77773284;89334346;CNV;11561062
8;;N;DEL;74845215;79664954;CNV;4819739
10;;N;DUP;69498313;80519397;CNV;11021084
11;;N;DEL;20667176;24520677;CNV;3853501
13;;N;DEL;79312312;91355226;CNV;12042914
17;;N;DUP;36103951;39906235;CNV;3802284
19;;N;DUP;54354787;55018681;CNV;663894
3;;N;DUP;195694980;195714957;CNV;19977
5;;N;DEL;69307989;71195398;CNV;1887409
8;;N;DUP;39766907;50016977;CNV;10250070
8;;N;DUP;55762669;145053383;CNV;89290714
1;;N;DEL;819073;91008176;CNV;90189103
1;;N;DUP;144017529;161614310;CNV;17596781
1;;N;DEL;161677789;161714006;CNV;36217
1;;N;DUP;161727815;248917362;CNV;87189547
3;;N;DUP;13373824;13504620;CNV;130796
6;;N;DUP;149660237;153151613;CNV;3491376
8;;N;DEL;67264;28378818;CNV;28311554
8;;N;DUP;28400008;29953272;CNV;1553264
8;;N;DEL;30069795;35525606;CNV;5455811
8;;N;DUP;35672475;37844104;CNV;2171629
8;;N;DUP;37863030;40015579;CNV;2152549
8;;N;DUP;40154217;43129845;CNV;2975628
8;;N;DUP;115412949;117965476;CNV;2552527
10;;N;DUP;7159150;11755540;CNV;4596390
11;;N;DUP;4992373;5269985;CNV;277612
11;;N;DUP;5284440;5709248;CNV;424808
11;;N;DUP;6151844;6571898;CNV;420054
11;;N;DEL;10095829;14505087;CNV;4409258
11;;N;DUP;20367224;21370904;CNV;1003680
11;;N;DEL;22282149;24520677;CNV;2238528
11;;N;DUP;27217410;27468645;CNV;251235
11;;N;DUP;31432543;32439842;CNV;1007299
11;;N;DUP;34646597;36648055;CNV;2001458
11;;N;DUP;63370051;63988714;CNV;618663
11;;N;DUP;66034712;66976838;CNV;942126
11;;N;DUP;67050412;67400889;CNV;350477
11;;N;DUP;68555598;70207323;CNV;1651725
11;;N;DUP;70375005;72793914;CNV;2418909
11;;N;DUP;72826734;75569048;CNV;2742314
11;;N;DUP;75599762;80834989;CNV;5235227
11;;N;DEL;82732199;134480876;CNV;51748677
13;;N;DUP;18906528;27256477;CNV;8349949
13;;N;DUP;27273323;27962202;CNV;688879
13;;N;DEL;28024908;114325399;CNV;86300491
14;;N;DEL;57295076;99680454;CNV;42385378
16;;N;DEL;31703297;47669343;CNV;15966046
16;;N;DUP;47886578;48596499;CNV;709921
16;;N;DUP;54919154;55567564;CNV;648410
16;;N;DEL;55700273;90171823;CNV;34471550
17;;N;DUP;42404291;43754213;CNV;1349922
17;;N;DEL;44355106;47589804;CNV;3234698
17;;N;DUP;48465984;49226716;CNV;760732
17;;N;DUP;49252638;55322761;CNV;6070123
17;;N;DUP;55326116;59602563;CNV;4276447
17;;N;DUP;59618752;61394652;CNV;1775900
17;;N;DUP;61408252;63433327;CNV;2025075
17;;N;DUP;63496903;64482955;CNV;986052
17;;N;DUP;64974637;65529922;CNV;555285
17;;N;DUP;65806124;67938253;CNV;2132129
17;;N;DUP;67955343;81189753;CNV;13234410
21;;N;DEL;27313695;29358317;CNV;2044622
21;;N;DUP;32791116;35038380;CNV;2247264
21;;N;DUP;37221548;37687508;CNV;465960
21;;N;DUP;38204289;39406050;CNV;1201761
21;;N;DUP;41142194;41408478;CNV;266284
21;;N;DEL;41458894;41717492;CNV;258598
21;;N;DUP;41739600;43170602;CNV;1431002
21;;N;DUP;44771403;46654410;CNV;1883007
22;;N;DEL;15813422;25360626;CNV;9547204
22;;N;DEL;25479545;25561737;CNV;82192
22;;N;DEL;25722812;50767910;CNV;25045098
1;;N;DEL;819073;116134801;CNV;115315728
1;;N;DUP;116387451;248917362;CNV;132529911
4;;N;DEL;26434520;38826921;CNV;12392401
4;;N;DUP;38914983;42657585;CNV;3742602
7;;N;DUP;22725730;23702164;CNV;976434
7;;N;DUP;23785561;32661145;CNV;8875584
7;;N;DUP;32729836;36242374;CNV;3512538
8;;N;DUP;36452849;38973428;CNV;2520579
8;;N;DUP;38988027;145053383;CNV;106065356
11;;N;DEL;100993560;106252825;CNV;5259265
12;;N;DEL;13221835;24249122;CNV;11027287
12;;N;DEL;40368215;42081957;CNV;1713742
15;;N;DEL;20360761;41387561;CNV;21026800
15;;N;DUP;59105203;59153742;CNV;48539
19;;N;DEL;42826708;43283499;CNV;456791
20;;N;DUP;96331;64265396;CNV;64169065
21;;N;DEL;10605620;43761641;CNV;33156021
21;;N;DUP;43776344;43800547;CNV;24203
21;;N;DEL;43805949;46654410;CNV;2848461
22;;N;DUP;15813422;50767910;CNV;34954488
1;;N;DUP;198253135;248917362;CNV;50664227
5;;N;DEL;69189590;71195398;CNV;2005808
6;;N;DEL;73242147;170577603;CNV;97335456
7;;N;DUP;132123780;132253889;CNV;130109
8;;N;DEL;32760376;48428406;CNV;15668030
8;;N;DEL;122812622;145053383;CNV;22240761
11;;N;DUP;105905226;106003812;CNV;98586
16;;N;DEL;35153323;74338864;CNV;39185541
16;;N;DEL;74408911;74419293;CNV;10382
16;;N;DEL;74447895;90171823;CNV;15723928
17;;N;DEL;183950;22413172;CNV;22229222
17;;N;DEL;46196583;46637262;CNV;440679
2;;N;DUP;65311745;65691867;CNV;380122
5;;N;DEL;70867807;71195398;CNV;327591
6;;N;DUP;159692721;160217296;CNV;524575
16;;N;DEL;74338864;74419293;CNV;80429
17;;N;DUP;4731479;4746016;CNV;14537
17;;N;DEL;46286803;46637262;CNV;350459
1;;N;DUP;16017114;16970666;CNV;953552
5;;N;DUP;169881399;170109392;CNV;227993
12;;N;DUP;4912831;4917864;CNV;5033
7;;N;DUP;5323938;5375420;CNV;51482
16;;N;DUP;24439;56363964;CNV;56339525
16;;N;DEL;74338864;74414454;CNV;75590
20;;N;DUP;49392797;49504347;CNV;111550
21;;N;DEL;10605620;32035055;CNV;21429435
5;;N;DUP;74628457;74689421;CNV;60964
7;;N;DUP;102496294;102647347;CNV;151053
12;;N;DUP;62644607;63006731;CNV;362124
14;;N;DEL;105587594;105767877;CNV;180283
16;;N;DEL;35023746;47155677;CNV;12131931
16;;N;DEL;47162607;74296855;CNV;27134248
17;;N;DEL;183950;22286505;CNV;22102555
17;;N;DEL;30522438;38177460;CNV;7655022
17;;N;DUP;41097467;41346200;CNV;248733
17;;N;DUP;56473013;57459660;CNV;986647
17;;N;DEL;75063130;76161564;CNV;1098434
17;;N;DUP;78502101;80423602;CNV;1921501
17;;N;DEL;80454437;83094727;CNV;2640290
5;;N;DEL;720408;819572;CNV;99164
8;;N;DUP;12412856;12414878;CNV;2022
15;;N;DEL;20360761;24568027;CNV;4207266
4;;N;DEL;188004841;190089947;CNV;2085106
8;;N;DUP;26395262;26397726;CNV;2464
9;;N;DUP;137813455;138122002;CNV;308547
10;;N;DUP;72886819;73069363;CNV;182544
10;;N;DUP;74118957;76598786;CNV;2479829
10;;N;DUP;76869719;79405154;CNV;2535435
11;;N;DUP;69297018;70635356;CNV;1338338
11;;N;DUP;70771270;71538589;CNV;767319
11;;N;DEL;71548825;76626715;CNV;5077890
11;;N;DUP;76657956;78653574;CNV;1995618
1;;N;DUP;148893279;248917362;CNV;100024083
2;;N;DEL;39143;14316999;CNV;14277856
3;;N;DEL;47169264;93884766;CNV;46715502
3;;N;DUP;101801959;109494362;CNV;7692403
6;;N;DEL;61901295;170577603;CNV;108676308
8;;N;DEL;7016759;36452849;CNV;29436090
8;;N;DUP;36888674;119731994;CNV;82843320
9;;N;DEL;29687;132670880;CNV;132641193
9;;N;DEL;132878264;132888406;CNV;10142
9;;N;DEL;132891827;138122002;CNV;5230175
10;;N;DUP;8255800;8260809;CNV;5009
14;;N;DEL;54420044;106504425;CNV;52084381
16;;N;DEL;33094984;90171823;CNV;57076839
19;;N;DEL;1389117;3123939;CNV;1734822
22;;N;DEL;16488008;50767910;CNV;34279902
17;;N;DUP;38671824;39929536;CNV;1257712
7;;N;DUP;102466218;102688224;CNV;222006
8;;N;DUP;12393317;12499225;CNV;105908
8;;N;DUP;28970414;30553663;CNV;1583249
8;;N;DUP;33512556;33591565;CNV;79009
9;;N;DEL;68499261;79532275;CNV;11033014
9;;N;DEL;111028739;113163754;CNV;2135015
17;;N;DUP;33530014;34639228;CNV;1109214
17;;N;DUP;35679515;35906372;CNV;226857
17;;N;DUP;39405531;40094047;CNV;688516
17;;N;DUP;40113320;40390040;CNV;276720
17;;N;DEL;67638783;72041084;CNV;4402301
1;;N;DUP;75732688;75794176;CNV;61488
1;;N;DUP;158031565;162566301;CNV;4534736
3;;N;DUP;86027920;86067175;CNV;39255
3;;N;DEL;195700131;195714957;CNV;14826
4;;N;DUP;185374201;188147237;CNV;2773036
5;;N;DEL;71027820;71083032;CNV;55212
6;;N;DUP;10745941;17130858;CNV;6384917
6;;N;DEL;35427459;41798796;CNV;6371337
6;;N;DEL;43225851;47009024;CNV;3783173
6;;N;DUP;103793617;107613975;CNV;3820358
6;;N;DEL;127269535;127708540;CNV;439005
6;;N;DEL;147384947;147737381;CNV;352434
6;;N;DEL;152102906;170577603;CNV;18474697
8;;N;DUP;36888674;38163699;CNV;1275025
8;;N;DUP;38210180;38446057;CNV;235877
8;;N;DUP;38748815;38973428;CNV;224613
8;;N;DUP;38988027;39082670;CNV;94643
8;;N;DUP;51319927;59120763;CNV;7800836
8;;N;DUP;59970653;99156686;CNV;39186033
8;;N;DUP;99875673;112223319;CNV;12347646
8;;N;DUP;115412949;144356847;CNV;28943898
8;;N;DUP;144360243;144509662;CNV;149419
8;;N;DUP;144513682;145053383;CNV;539701
9;;N;DUP;29687;117139;CNV;87452
9;;N;DUP;137612971;138122002;CNV;509031
14;;N;DEL;58131591;58410872;CNV;279281
16;;N;DUP;2457671;2855775;CNV;398104
16;;N;DUP;17103312;19733731;CNV;2630419
16;;N;DUP;20849487;22610699;CNV;1761212
17;;N;DEL;19189814;19219736;CNV;29922
19;;N;DUP;51592080;51646348;CNV;54268
19;;N;DUP;53166243;56185336;CNV;3019093
11;;N;DUP;9460532;9525350;CNV;64818
15;;N;DUP;20360761;23568158;CNV;3207397
15;;N;DUP;68812298;101654591;CNV;32842293
19;;N;DUP;58341976;58478132;CNV;136156
1;;N;DUP;206470604;207322518;CNV;851914
2;;N;DUP;2895477;9490066;CNV;6594589
2;;N;DUP;110123843;110382830;CNV;258987
2;;N;DUP;130345413;130764701;CNV;419288
3;;N;DUP;93884766;100178342;CNV;6293576
3;;N;DUP;136330104;137765463;CNV;1435359
7;;N;DUP;87110892;90119691;CNV;3008799
7;;N;DUP;128304399;128772621;CNV;468222
7;;N;DUP;128822081;130166474;CNV;1344393
7;;N;DUP;130507730;131052518;CNV;544788
7;;N;DUP;143350425;143852366;CNV;501941
8;;N;DEL;7007236;7934441;CNV;927205
8;;N;DUP;42151938;112223319;CNV;70071381
8;;N;DUP;115412949;116298741;CNV;885792
8;;N;DUP;118069787;118245316;CNV;175529
8;;N;DUP;118378526;124951028;CNV;6572502
8;;N;DUP;124979238;129876456;CNV;4897218
9;;N;DUP;126613679;127482979;CNV;869300
9;;N;DUP;132242565;132888406;CNV;645841
17;;N;DUP;18511658;18605893;CNV;94235
17;;N;DUP;20318916;20416438;CNV;97522
17;;N;DUP;39636486;39742282;CNV;105796
17;;N;DUP;48294383;49704129;CNV;1409746
17;;N;DUP;49711003;51747780;CNV;2036777
17;;N;DUP;58301550;60431272;CNV;2129722
1;;N;DUP;193176922;197505619;CNV;4328697
7;;N;DUP;11051680;20353113;CNV;9301433
7;;N;DEL;101002288;101034599;CNV;32311
10;;N;DUP;22254053;22391804;CNV;137751
11;;N;DUP;122089896;122152269;CNV;62373
12;;N;DUP;20426231;23190307;CNV;2764076
12;;N;DUP;133059467;133202201;CNV;142734
13;;N;DUP;37636922;38533013;CNV;896091
15;;N;DUP;55539101;55615079;CNV;75978
17;;N;DUP;39405531;39929536;CNV;524005
17;;N;DUP;51250637;55773865;CNV;4523228
17;;N;DEL;56473013;57836346;CNV;1363333
1;;N;DUP;59990507;62834078;CNV;2843571
1;;N;DUP;207069498;207091684;CNV;22186
5;;N;DUP;10994597;11107864;CNV;113267
10;;N;DUP;71819504;77977507;CNV;6158003
11;;N;DEL;27891076;27987717;CNV;96641
15;;N;DEL;20360761;23011247;CNV;2650486
17;;N;DUP;38671824;39766117;CNV;1094293
17;;N;DUP;45835401;45847028;CNV;11627
18;;N;DUP;121261;1940074;CNV;1818813
19;;N;DUP;3851896;4117515;CNV;265619
19;;N;DUP;10350630;12081257;CNV;1730627
20;;N;DUP;34714960;37022784;CNV;2307824
20;;N;DUP;46686878;48370466;CNV;1683588
20;;N;DUP;56367129;64265396;CNV;7898267
1;;N;DEL;973545;1916785;CNV;943240
1;;N;DEL;1917861;1941541;CNV;23680
1;;N;DUP;152153830;152655515;CNV;501685
1;;N;DEL;156658206;156736814;CNV;78608
1;;N;DUP;228743730;248917362;CNV;20173632
2;;N;DUP;131648787;132783806;CNV;1135019
2;;N;DUP;202037297;203448028;CNV;1410731
2;;N;DUP;203722633;205563496;CNV;1840863
2;;N;DUP;205615771;207602860;CNV;1987089
2;;N;DUP;208493721;213297319;CNV;4803598
2;;N;DEL;238510737;242088078;CNV;3577341
3;;N;DEL;48294652;52525054;CNV;4230402
3;;N;DUP;101859813;118902320;CNV;17042507
3;;N;DUP;147422067;155183101;CNV;7761034
3;;N;DUP;167242562;172397340;CNV;5154778
3;;N;DUP;172421720;194049275;CNV;21627555
5;;N;DEL;68322878;71644761;CNV;3321883
6;;N;DUP;152122045;155396921;CNV;3274876
7;;N;DEL;881289;2259075;CNV;1377786
7;;N;DUP;63843306;65722394;CNV;1879088
7;;N;DUP;67339957;71836472;CNV;4496515
7;;N;DEL;76277355;76637576;CNV;360221
7;;N;DUP;77011954;97858897;CNV;20846943
7;;N;DUP;102813485;132484847;CNV;29671362
7;;N;DUP;135181652;143417917;CNV;8236265
7;;N;DUP;143728960;144363438;CNV;634478
7;;N;DEL;148988935;154893381;CNV;5904446
8;;N;DEL;140102783;145053383;CNV;4950600
9;;N;DEL;126505473;126767704;CNV;262231
9;;N;DEL;133363433;138122002;CNV;4758569
11;;N;DEL;199994;2848861;CNV;2648867
11;;N;DEL;47052418;47415336;CNV;362918
12;;N;DUP;67329;5470942;CNV;5403613
12;;N;DUP;8520304;11770521;CNV;3250217
12;;N;DUP;12087354;14793861;CNV;2706507
12;;N;DUP;14805819;30996534;CNV;16190715
12;;N;DUP;115960757;116161054;CNV;200297
12;;N;DEL;132203610;132685561;CNV;481951
12;;N;DEL;132687379;133032902;CNV;345523
13;;N;DUP;20181869;20437802;CNV;255933
13;;N;DUP;81226420;112800311;CNV;31573891
13;;N;DUP;112866536;114325399;CNV;1458863
14;;N;DEL;100330327;106504425;CNV;6174098
15;;N;DUP;80196045;82157749;CNV;1961704
16;;N;DEL;24439;2457671;CNV;2433232
16;;N;DEL;67394542;67842619;CNV;448077
16;;N;DEL;83795767;90171823;CNV;6376056
17;;N;DUP;64880050;67340195;CNV;2460145
17;;N;DEL;74210414;83094727;CNV;8884313
19;;N;DEL;288125;8697470;CNV;8409345
19;;N;DUP;8811234;9758559;CNV;947325
20;;N;DEL;3659438;3918195;CNV;258757
21;;N;DUP;10605620;25911928;CNV;15306308
21;;N;DUP;25993500;27745898;CNV;1752398
22;;N;DUP;15813422;16488008;CNV;674586
2;;N;DEL;42756849;43226294;CNV;469445
4;;N;DEL;189273710;190089947;CNV;816237
5;;N;DUP;127551742;132036773;CNV;4485031
5;;N;DUP;151790918;154054755;CNV;2263837
6;;N;DUP;80171319;82170699;CNV;1999380
8;;N;DEL;12412856;12421248;CNV;8392
8;;N;DUP;36452849;37963335;CNV;1510486
8;;N;DUP;47191636;140821329;CNV;93629693
9;;N;DUP;138060692;138122002;CNV;61310
10;;N;DUP;6463936;11755540;CNV;5291604
10;;N;DUP;14519796;29463473;CNV;14943677
10;;N;DUP;47001376;59174073;CNV;12172697
10;;N;DUP;87244441;94338667;CNV;7094226
19;;N;DEL;288125;36009209;CNV;35721084
20;;N;DUP;96331;279222;CNV;182891
20;;N;DUP;3933742;10306621;CNV;6372879
20;;N;DUP;10311494;19551645;CNV;9240151
20;;N;DUP;19722253;22676345;CNV;2954092
20;;N;DEL;62134715;64265396;CNV;2130681
1;;N;DEL;84628743;84646299;CNV;17556
8;;N;DUP;131999547;132013049;CNV;13502
1;;N;DUP;144017529;155045567;CNV;11028038
1;;N;DUP;155316925;248917362;CNV;93600437
4;;N;DEL;163351183;163471312;CNV;120129
15;;N;DEL;32168671;32575952;CNV;407281
1;;N;DUP;152306622;152579436;CNV;272814
1;;N;DEL;155172594;155316925;CNV;144331
1;;N;DUP;158356549;159440201;CNV;1083652
1;;N;DUP;159588594;160031783;CNV;443189
1;;N;DUP;160038512;175880309;CNV;15841797
1;;N;DUP;179564751;185128713;CNV;5563962
1;;N;DEL;185264056;185301114;CNV;37058
1;;N;DUP;185563268;186673139;CNV;1109871
1;;N;DUP;195646617;197421888;CNV;1775271
1;;N;DUP;199006778;201359213;CNV;2352435
1;;N;DUP;202591123;219442607;CNV;16851484
1;;N;DUP;219912031;227697076;CNV;7785045
2;;N;DUP;105770033;105883005;CNV;112972
4;;N;DEL;163324811;163471312;CNV;146501
8;;N;DUP;26370434;28527744;CNV;2157310
8;;N;DUP;101201657;101369698;CNV;168041
8;;N;DUP;102379193;103400211;CNV;1021018
8;;N;DUP;115412949;116936675;CNV;1523726
11;;N;DUP;6503142;6548337;CNV;45195
17;;N;DEL;76489768;76531642;CNV;41874
6;;N;DUP;106323616;106568649;CNV;245033
6;;N;DUP;106588740;107870887;CNV;1282147
6;;N;DUP;108043854;110393040;CNV;2349186
6;;N;DUP;122796858;129577868;CNV;6781010
9;;N;DUP;110322737;110366514;CNV;43777
10;;N;DUP;10786705;14913230;CNV;4126525
11;;N;DUP;9839224;18137474;CNV;8298250
11;;N;DUP;29980359;31783430;CNV;1803071
11;;N;DUP;31789966;33356914;CNV;1566948
11;;N;DUP;69653252;69675220;CNV;21968
20;;N;DEL;21715920;22068570;CNV;352650
10;;N;DUP;173180;42103941;CNV;41930761
11;;N;DUP;94179950;96713183;CNV;2533233
12;;N;DUP;67329;566024;CNV;498695
12;;N;DUP;645030;1419450;CNV;774420
16;;N;DEL;30356838;31703297;CNV;1346459
17;;N;DUP;36940486;38926598;CNV;1986112
17;;N;DUP;39067814;39406759;CNV;338945
17;;N;DUP;39674024;39876753;CNV;202729
17;;N;DUP;61387445;75004816;CNV;13617371
19;;N;DUP;12156616;12188622;CNV;32006
7;;N;DUP;150447256;150478807;CNV;31551
8;;N;DEL;7712897;7896517;CNV;183620
8;;N;DUP;36888674;39766907;CNV;2878233
8;;N;DUP;39903945;40154217;CNV;250272
8;;N;DUP;40530695;41828369;CNV;1297674
8;;N;DUP;41932414;41962575;CNV;30161
8;;N;DUP;42151938;43129845;CNV;977907
8;;N;DUP;81801529;107250141;CNV;25448612
8;;N;DUP;108248643;138151231;CNV;29902588
8;;N;DUP;138588536;141431439;CNV;2842903
8;;N;DUP;143280911;143366738;CNV;85827
8;;N;DUP;144698779;145053383;CNV;354604
11;;N;DUP;5561628;5709248;CNV;147620
11;;N;DUP;6520549;9743804;CNV;3223255
11;;N;DUP;12901982;18400870;CNV;5498888
11;;N;DUP;18412749;18728087;CNV;315338
11;;N;DUP;18934468;28352123;CNV;9417655
11;;N;DUP;32589587;33170464;CNV;580877
11;;N;DUP;33353275;36274679;CNV;2921404
11;;N;DUP;100308438;103091825;CNV;2783387
12;;N;DUP;101486627;101685714;CNV;199087
17;;N;DEL;10131088;13777270;CNV;3646182
17;;N;DEL;18725658;19416956;CNV;691298
19;;N;DUP;57131463;57428240;CNV;296777
19;;N;DUP;57430055;57697447;CNV;267392
19;;N;DUP;57720255;57796427;CNV;76172
20;;N;DUP;96331;25734729;CNV;25638398
20;;N;DUP;46686878;53574935;CNV;6888057
21;;N;DUP;10605620;15052213;CNV;4446593
1;;N;DUP;16426;826715;CNV;810289
2;;N;DEL;110612211;112339859;CNV;1727648
3;;N;DUP;119923418;120096153;CNV;172735
4;;N;DEL;163324811;163351183;CNV;26372
13;;N;DEL;35671036;74555621;CNV;38884585
22;;N;DUP;21622045;21628754;CNV;6709
17;;N;DUP;59602563;64320500;CNV;4717937
21;;N;DEL;37782483;37801775;CNV;19292
22;;N;DEL;40597034;40779071;CNV;182037
6;;N;DEL;186414;410658;CNV;224244
6;;N;DEL;6654609;10756703;CNV;4102094
6;;N;DEL;27147524;27450871;CNV;303347
7;;N;DEL;76307292;76505404;CNV;198112
7;;N;DEL;77091028;86912162;CNV;9821134
8;;N;DUP;32760376;112223319;CNV;79462943
8;;N;DUP;115412949;141390368;CNV;25977419
8;;N;DUP;141431439;145053383;CNV;3621944
10;;N;DEL;44976518;46453029;CNV;1476511
13;;N;DEL;18906528;19650198;CNV;743670
13;;N;DEL;59916200;74408460;CNV;14492260
13;;N;DEL;111103014;114325399;CNV;3222385
16;;N;DEL;89885877;89967887;CNV;82010
18;;N;DUP;20980396;80184101;CNV;59203705
19;;N;DUP;11738864;12973726;CNV;1234862
5;;N;DUP;720408;763549;CNV;43141
8;;N;DUP;47677636;47774266;CNV;96630
8;;N;DEL;49134793;51319927;CNV;2185134
8;;N;DUP;66923130;67199012;CNV;275882
8;;N;DUP;90948929;91102765;CNV;153836
8;;N;DUP;91338189;145053383;CNV;53715194
11;;N;DEL;55827690;57551912;CNV;1724222
11;;N;DUP;65948117;72425589;CNV;6477472
11;;N;DUP;78079783;78436765;CNV;356982
11;;N;DUP;93144704;95191527;CNV;2046823
11;;N;DEL;95779636;134480876;CNV;38701240
16;;N;DEL;66580074;69160399;CNV;2580325
21;;N;DEL;46003970;46191101;CNV;187131
11;;N;DUP;129697845;130239857;CNV;542012
12;;N;DUP;67312734;75042343;CNV;7729609
19;;N;DUP;27776105;30029712;CNV;2253607
1;;N;DEL;16426;45329335;CNV;45312909
2;;N;DEL;240139181;240691943;CNV;552762
3;;N;DEL;46670628;52525054;CNV;5854426
4;;N;DEL;957943;2072262;CNV;1114319
6;;N;DUP;186414;31558600;CNV;31372186
6;;N;DUP;31863563;32903173;CNV;1039610
7;;N;DUP;7238370;26899062;CNV;19660692
7;;N;DEL;63396439;86850508;CNV;23454069
7;;N;DEL;100064740;102678631;CNV;2613891
8;;N;DEL;141224051;145053383;CNV;3829332
11;;N;DEL;199994;12535184;CNV;12335190
11;;N;DUP;12901982;43920051;CNV;31018069
11;;N;DUP;68158433;68615067;CNV;456634
11;;N;DEL;71092499;74336605;CNV;3244106
11;;N;DUP;101452753;101963635;CNV;510882
11;;N;DUP;106003812;111293749;CNV;5289937
12;;N;DEL;132141880;132844056;CNV;702176
14;;N;DEL;104589719;105922299;CNV;1332580
16;;N;DEL;24439;4804593;CNV;4780154
16;;N;DUP;35197322;35506375;CNV;309053
16;;N;DEL;49921044;90171823;CNV;40250779
17;;N;DEL;32933217;33013723;CNV;80506
17;;N;DEL;63932317;64002899;CNV;70582
20;;N;DEL;96331;417761;CNV;321430
20;;N;DEL;61940365;64265396;CNV;2325031
19;;N;DUP;19504471;23255437;CNV;3750966
19;;N;DUP;23316671;24128075;CNV;811404
1;;N;DEL;913921;6413247;CNV;5499326
1;;N;DEL;6460340;37612085;CNV;31151745
1;;N;DEL;154945745;155289694;CNV;343949
2;;N;DEL;239094055;242088078;CNV;2994023
3;;N;DEL;47334788;52525054;CNV;5190266
4;;N;DEL;836645;2072262;CNV;1235617
4;;N;DEL;189551180;190089947;CNV;538767
5;;N;DEL;176527759;177520074;CNV;992315
6;;N;DEL;122717910;122796858;CNV;78948
7;;N;DEL;195646;2269597;CNV;2073951
7;;N;DUP;6690722;27093362;CNV;20402640
7;;N;DUP;27412265;43953198;CNV;16540933
7;;N;DUP;45724410;56534652;CNV;10810242
7;;N;DEL;100221409;101094949;CNV;873540
8;;N;DEL;141353494;145053383;CNV;3699889
11;;N;DEL;199994;3000974;CNV;2800980
11;;N;DEL;11956806;12358743;CNV;401937
11;;N;DUP;12361977;43912316;CNV;31550339
11;;N;DUP;68158433;68691073;CNV;532640
11;;N;DEL;71092499;74037511;CNV;2945012
11;;N;DUP;105905226;110463100;CNV;4557874
12;;N;DEL;132203610;132844056;CNV;640446
14;;N;DEL;102500053;105922299;CNV;3422246
15;;N;DEL;40247316;40979599;CNV;732283
15;;N;DEL;64154663;64155887;CNV;1224
16;;N;DEL;27447788;35153323;CNV;7705535
16;;N;DEL;35786613;90171823;CNV;54385210
17;;N;DEL;80468740;83094727;CNV;2625987
20;;N;DEL;62201131;64265396;CNV;2064265
21;;N;DEL;42297059;46191101;CNV;3894042
22;;N;DEL;49963953;50767910;CNV;803957
1;;N;DUP;144017529;147995842;CNV;3978313
1;;N;DUP;148013488;148423564;CNV;410076
16;;N;DUP;31711599;35197322;CNV;3485723
1;;N;DUP;161518275;161727815;CNV;209540
1;;N;DEL;819073;6413247;CNV;5594174
2;;N;DEL;42442572;43452574;CNV;1010002
2;;N;DEL;218637080;221574051;CNV;2936971
3;;N;DEL;52293161;52525054;CNV;231893
5;;N;DEL;176527759;177610037;CNV;1082278
6;;N;DEL;186414;537187;CNV;350773
6;;N;DUP;56541305;63281110;CNV;6739805
6;;N;DUP;63580307;69675066;CNV;6094759
7;;N;DEL;44014753;45719317;CNV;1704564
7;;N;DEL;100093812;102678631;CNV;2584819
7;;N;DEL;130275214;130381761;CNV;106547
7;;N;DUP;148874017;148941541;CNV;67524
10;;N;DEL;132417575;133555381;CNV;1137806
11;;N;DEL;199994;3222817;CNV;3022823
11;;N;DUP;59557385;59853006;CNV;295621
11;;N;DUP;61964245;62433628;CNV;469383
11;;N;DEL;62553754;68691073;CNV;6137319
11;;N;DUP;68747253;70564624;CNV;1817371
11;;N;DEL;70635356;77214860;CNV;6579504
11;;N;DUP;77336116;79968048;CNV;2631932
12;;N;DEL;132203610;132728130;CNV;524520
14;;N;DEL;99511022;106504425;CNV;6993403
16;;N;DEL;24439;3146465;CNV;3122026
16;;N;DEL;88184390;89195900;CNV;1011510
17;;N;DEL;183950;27078631;CNV;26894681
17;;N;DUP;46034205;47677089;CNV;1642884
17;;N;DUP;50699489;63895555;CNV;13196066
17;;N;DEL;63932317;64130118;CNV;197801
17;;N;DUP;64148965;73277920;CNV;9128955
20;;N;DEL;62139726;64265396;CNV;2125670
2;;N;DUP;91544300;94759413;CNV;3215113
2;;N;DUP;111322394;111772393;CNV;449999
7;;N;DUP;102496294;102678631;CNV;182337
13;;N;DEL;24426551;26213834;CNV;1787283
13;;N;DEL;31802652;87807950;CNV;56005298
16;;N;DEL;46697583;90096239;CNV;43398656
7;;N;DUP;27412265;31823108;CNV;4410843
7;;N;DUP;31857349;34153692;CNV;2296343
7;;N;DUP;35689785;41133444;CNV;5443659
7;;N;DUP;63396439;128458182;CNV;65061743
7;;N;DUP;128471971;128589923;CNV;117952
7;;N;DUP;128691292;159028254;CNV;30336962
8;;N;DUP;30156329;30417626;CNV;261297
8;;N;DUP;36452849;37765601;CNV;1312752
8;;N;DUP;37843181;38408435;CNV;565254
8;;N;DUP;38424641;40530695;CNV;2106054
9;;N;DEL;20827189;26842457;CNV;6015268
10;;N;DEL;42352053;65920348;CNV;23568295
10;;N;DUP;67111750;67155102;CNV;43352
10;;N;DUP;72886819;73645634;CNV;758815
10;;N;DUP;73744007;74118957;CNV;374950
10;;N;DUP;74123406;75094517;CNV;971111
10;;N;DUP;76058735;80218245;CNV;4159510
10;;N;DUP;80272539;81501649;CNV;1229110
10;;N;DEL;82669531;87205249;CNV;4535718
10;;N;DUP;87244441;87366981;CNV;122540
11;;N;DUP;67584730;67628128;CNV;43398
11;;N;DUP;69416390;69698634;CNV;282244
11;;N;DUP;72358978;77022040;CNV;4663062
11;;N;DUP;77040155;77571638;CNV;531483
15;;N;DEL;20360761;44767554;CNV;24406793
16;;N;DEL;24439;47527;CNV;23088
17;;N;DUP;47981193;49142134;CNV;1160941
17;;N;DUP;49596263;50284121;CNV;687858
17;;N;DUP;56473013;64002899;CNV;7529886
17;;N;DUP;64003688;64895216;CNV;891528
17;;N;DUP;64945194;65851962;CNV;906768
17;;N;DUP;66220691;70179881;CNV;3959190
17;;N;DUP;70832116;75004816;CNV;4172700
17;;N;DUP;75012800;76531642;CNV;1518842
17;;N;DUP;76553504;78899659;CNV;2346155
1;;N;DUP;169589048;248917362;CNV;79328314
5;;N;DUP;114447634;114496284;CNV;48650
11;;N;DEL;10095829;13700395;CNV;3604566
11;;N;DUP;13921713;57376874;CNV;43455161
20;;N;DEL;11913434;11926401;CNV;12967
1;;N;DUP;149617588;248917362;CNV;99299774
8;;N;DEL;12412856;12414878;CNV;2022
18;;N;DUP;12802121;13741576;CNV;939455
21;;N;DUP;46242792;46654410;CNV;411618
22;;N;DEL;19125573;20407026;CNV;1281453
3;;N;DUP;33390158;33455172;CNV;65014
4;;N;DUP;70793175;70798422;CNV;5247
17;;N;DUP;18812621;19219736;CNV;407115
17;;N;DEL;46286803;46540700;CNV;253897
4;;N;DUP;65335961;68338327;CNV;3002366
4;;N;DUP;69589305;76140802;CNV;6551497
4;;N;DUP;123383893;123403006;CNV;19113
13;;N;DUP;32911058;33836180;CNV;925122
15;;N;DUP;40816200;40836249;CNV;20049
1;;N;DUP;200043838;248917362;CNV;48873524
3;;N;DUP;120096153;124678283;CNV;4582130
3;;N;DUP;129387220;198038635;CNV;68651415
5;;N;DUP;184359;9214732;CNV;9030373
5;;N;DUP;9225755;29982554;CNV;20756799
5;;N;DEL;87229816;100905559;CNV;13675743
5;;N;DUP;107378629;181275946;CNV;73897317
6;;N;DEL;27807901;27808624;CNV;723
6;;N;DUP;138412977;155396921;CNV;16983944
6;;N;DEL;156776610;170577603;CNV;13800993
7;;N;DEL;122054008;159028254;CNV;36974246
8;;N;DEL;67264;32760376;CNV;32693112
8;;N;DUP;33044550;71535812;CNV;38491262
8;;N;DUP;71842231;119731994;CNV;47889763
8;;N;DUP;119834133;133776102;CNV;13941969
9;;N;DEL;29687;4259015;CNV;4229328
9;;N;DEL;32648422;138122002;CNV;105473580
10;;N;DUP;173180;16824891;CNV;16651711
10;;N;DEL;103387322;115361901;CNV;11974579
11;;N;DEL;106003812;134480876;CNV;28477064
13;;N;DEL;37698748;114325399;CNV;76626651
16;;N;DEL;54919154;68355804;CNV;13436650
16;;N;DEL;68358995;68567058;CNV;208063
16;;N;DEL;68684619;90171823;CNV;21487204
17;;N;DEL;183950;20609431;CNV;20425481
18;;N;DEL;20991221;35373526;CNV;14382305
18;;N;DUP;35405197;35617581;CNV;212384
18;;N;DUP;36779824;37273114;CNV;493290
18;;N;DEL;39207941;80138503;CNV;40930562
19;;N;DEL;288125;4354390;CNV;4066265
20;;N;DUP;34981146;57408888;CNV;22427742
20;;N;DUP;57497582;62134715;CNV;4637133
20;;N;DUP;62139726;64265396;CNV;2125670
22;;N;DEL;35087328;50767910;CNV;15680582
1;;N;DUP;6653981;6724682;CNV;70701
1;;N;DUP;144017529;163421254;CNV;19403725
3;;N;DUP;147395883;155845579;CNV;8449696
3;;N;DUP;167684189;172302328;CNV;4618139
4;;N;DEL;13456578;14139647;CNV;683069
4;;N;DEL;149278008;190089947;CNV;40811939
5;;N;DEL;59982532;71195398;CNV;11212866
6;;N;DUP;537187;21596391;CNV;21059204
6;;N;DEL;154842000;170577603;CNV;15735603
8;;N;DUP;60732339;99156686;CNV;38424347
11;;N;DEL;100993560;115755685;CNV;14762125
13;;N;DEL;48253877;50020259;CNV;1766382
15;;N;DUP;95501550;101654591;CNV;6153041
17;;N;DEL;183950;212872;CNV;28922
17;;N;DEL;22266332;22286505;CNV;20173
17;;N;DUP;49204107;67826243;CNV;18622136
19;;N;DUP;38283661;38304245;CNV;20584
22;;N;DUP;21363172;21545913;CNV;182741
2;;N;DUP;65268688;65311745;CNV;43057
8;;N;DEL;7712897;8242043;CNV;529146
8;;N;DUP;8317946;9326220;CNV;1008274
8;;N;DUP;10488574;10896474;CNV;407900
8;;N;DUP;35389532;39610665;CNV;4221133
16;;N;DUP;4804593;4832819;CNV;28226
19;;N;DUP;10317097;10350630;CNV;33533
20;;N;DUP;43540785;44750929;CNV;1210144
20;;N;DUP;44887689;45708196;CNV;820507
20;;N;DUP;46367095;51790326;CNV;5423231
20;;N;DUP;51832065;62134715;CNV;10302650
20;;N;DUP;62139726;62671974;CNV;532248
20;;N;DUP;63345147;64265396;CNV;920249
1;;N;DEL;202521109;202561441;CNV;40332
2;;N;DUP;96859937;97423347;CNV;563410
8;;N;DUP;7007236;7881410;CNV;874174
8;;N;DUP;63061339;63469908;CNV;408569
8;;N;DUP;73322714;94881379;CNV;21558665
8;;N;DUP;94926693;101369698;CNV;6443005
8;;N;DUP;101491389;128018631;CNV;26527242
9;;N;DUP;32635635;36063849;CNV;3428214
11;;N;DUP;69416390;70207323;CNV;790933
14;;N;DEL;105587594;106288167;CNV;700573
17;;N;DUP;34639228;35259036;CNV;619808
17;;N;DUP;39167373;40225627;CNV;1058254
17;;N;DUP;48294383;49296171;CNV;1001788
17;;N;DUP;49404121;50872169;CNV;1468048
1;;N;DEL;16535127;16895021;CNV;359894
1;;N;DEL;112457067;113132110;CNV;675043
1;;N;DUP;115691221;119894440;CNV;4203219
9;;N;DUP;96607812;96641821;CNV;34009
14;;N;DEL;70155708;70416962;CNV;261254
17;;N;DEL;10309794;12672045;CNV;2362251
17;;N;DUP;39532022;40278375;CNV;746353
17;;N;DUP;41046754;41436809;CNV;390055
22;;N;DUP;25360626;25561737;CNV;201111
22;;N;DUP;42572466;42615339;CNV;42873
1;;N;DEL;913921;6579326;CNV;5665405
2;;N;DUP;65311745;66696623;CNV;1384878
3;;N;DUP;114319539;114764503;CNV;444964
5;;N;DUP;4439134;9230512;CNV;4791378
5;;N;DUP;9236350;9257199;CNV;20849
5;;N;DUP;42483296;42549633;CNV;66337
9;;N;DUP;68499261;68957055;CNV;457794
9;;N;DEL;133357038;138122002;CNV;4764964
14;;N;DEL;102710965;105922299;CNV;3211334
17;;N;DUP;38322950;38755955;CNV;433005
17;;N;DUP;38779413;39248264;CNV;468851
17;;N;DUP;39605638;39929536;CNV;323898
17;;N;DUP;50699489;74250295;CNV;23550806
17;;N;DEL;74309336;83094727;CNV;8785391
19;;N;DEL;44662208;45181591;CNV;519383
20;;N;DEL;61933028;64099995;CNV;2166967
20;;N;DUP;64106744;64265396;CNV;158652
21;;N;DEL;43030614;46191101;CNV;3160487
22;;N;DEL;49963953;50613624;CNV;649671
1;;N;DUP;150267152;152348959;CNV;2081807
1;;N;DUP;234528267;234758194;CNV;229927
2;;N;DUP;111322394;111492238;CNV;169844
2;;N;DEL;184604729;235730346;CNV;51125617
2;;N;DEL;239735383;240139181;CNV;403798
3;;N;DUP;3140557;43432648;CNV;40292091
3;;N;DUP;52381675;52899417;CNV;517742
4;;N;DUP;118680526;119551921;CNV;871395
4;;N;DEL;128122079;190089947;CNV;61967868
5;;N;DUP;184359;51667345;CNV;51482986
5;;N;DEL;52800679;181275946;CNV;128475267
7;;N;DUP;102256174;105013597;CNV;2757423
8;;N;DUP;35525606;37765601;CNV;2239995
8;;N;DUP;37843181;39323016;CNV;1479835
8;;N;DEL;39610665;43201670;CNV;3591005
8;;N;DUP;46260814;135647067;CNV;89386253
8;;N;DUP;136669306;145053383;CNV;8384077
9;;N;DEL;3856135;4706438;CNV;850303
9;;N;DEL;64501360;138122002;CNV;73620642
10;;N;DUP;173180;43860288;CNV;43687108
10;;N;DEL;44976518;51234073;CNV;6257555
10;;N;DEL;73672845;73713959;CNV;41114
11;;N;DEL;199994;2130968;CNV;1930974
11;;N;DUP;2135485;2148164;CNV;12679
11;;N;DEL;2159903;8689251;CNV;6529348
11;;N;DUP;15966516;15972946;CNV;6430
11;;N;DUP;18934468;20389784;CNV;1455316
11;;N;DUP;61299875;61339095;CNV;39220
15;;N;DUP;88905849;90277125;CNV;1371276
18;;N;DEL;51031149;51467878;CNV;436729
18;;N;DEL;57354443;57476747;CNV;122304
19;;N;DUP;23928713;37267612;CNV;13338899
20;;N;DEL;96331;7302588;CNV;7206257
20;;N;DUP;7883120;16041242;CNV;8158122
22;;N;DUP;25360626;27852124;CNV;2491498
22;;N;DUP;36265826;36628691;CNV;362865
22;;N;DUP;37757766;38294499;CNV;536733
1;;N;DUP;16431283;17044839;CNV;613556
2;;N;DEL;131648787;131728287;CNV;79500
3;;N;DUP;75675810;75738730;CNV;62920
8;;N;DUP;67264;187249;CNV;119985
14;;N;DUP;59464062;59484028;CNV;19966
15;;N;DUP;68193922;68291037;CNV;97115
15;;N;DUP;88135997;88905849;CNV;769852
15;;N;DUP;89113780;89951180;CNV;837400
15;;N;DUP;90025765;90277125;CNV;251360
15;;N;DUP;90882272;90966187;CNV;83915
15;;N;DUP;92444861;93554299;CNV;1109438
16;;N;DUP;24439;84343;CNV;59904
16;;N;DUP;25020286;28098524;CNV;3078238
16;;N;DUP;28964392;30189011;CNV;1224619
17;;N;DUP;38402192;38542418;CNV;140226
17;;N;DUP;39532022;40093642;CNV;561620
17;;N;DUP;40094047;40278375;CNV;184328
17;;N;DUP;49828508;51183638;CNV;1355130
17;;N;DUP;51195318;53825087;CNV;2629769
17;;N;DUP;61743101;62693480;CNV;950379
17;;N;DUP;62736391;62836273;CNV;99882
17;;N;DUP;63243690;63860745;CNV;617055
17;;N;DUP;63895374;64130118;CNV;234744
17;;N;DUP;64974637;66415008;CNV;1440371
17;;N;DUP;68255729;68679322;CNV;423593
22;;N;DUP;18994485;19023069;CNV;28584
1;;N;DUP;144017529;202331797;CNV;58314268
1;;N;DUP;202561441;248917362;CNV;46355921
17;;N;DUP;39554337;39742282;CNV;187945
17;;N;DUP;39763255;39933142;CNV;169887
1;;N;DUP;16426;857047;CNV;840621
8;;N;DUP;67264;7055411;CNV;6988147
8;;N;DUP;7934441;12172025;CNV;4237584
8;;N;DUP;12421248;145053383;CNV;132632135
16;;N;DUP;5090517;14326148;CNV;9235631
1;;N;DEL;819073;14820984;CNV;14001911
1;;N;DUP;59990507;110022287;CNV;50031780
1;;N;DUP;110050378;111432019;CNV;1381641
1;;N;DUP;111441353;112529891;CNV;1088538
1;;N;DUP;182064845;248917362;CNV;66852517
2;;N;DEL;136115211;162008631;CNV;25893420
2;;N;DEL;231393703;242088078;CNV;10694375
3;;N;DEL;55879387;77646108;CNV;21766721
3;;N;DUP;87254092;98169107;CNV;10915015
3;;N;DUP;108320922;112562195;CNV;4241273
3;;N;DUP;112597008;114236118;CNV;1639110
3;;N;DUP;114294007;147395883;CNV;33101876
3;;N;DUP;147414509;150660115;CNV;3245606
3;;N;DUP;150741868;180870663;CNV;30128795
3;;N;DEL;186349650;193312884;CNV;6963234
3;;N;DUP;193440603;198038635;CNV;4598032
4;;N;DEL;76174210;117084566;CNV;40910356
5;;N;DEL;184359;44388581;CNV;44204222
5;;N;DEL;66662368;92405853;CNV;25743485
5;;N;DEL;107378629;113013818;CNV;5635189
5;;N;DEL;143153842;181275946;CNV;38122104
6;;N;DUP;75255407;133529139;CNV;58273732
6;;N;DUP;133623377;135284165;CNV;1660788
6;;N;DUP;135642241;142751851;CNV;7109610
7;;N;DUP;17286486;31111087;CNV;13824601
7;;N;DUP;31338174;35876376;CNV;4538202
7;;N;DEL;133691287;158934177;CNV;25242890
7;;N;DUP;159020711;159028254;CNV;7543
8;;N;DUP;96333505;107251680;CNV;10918175
8;;N;DUP;107899870;134477929;CNV;26578059
8;;N;DUP;134792443;145053383;CNV;10260940
9;;N;DUP;29687;178941;CNV;149254
9;;N;DEL;213621;37438171;CNV;37224550
10;;N;DUP;173180;6842239;CNV;6669059
10;;N;DUP;6849644;24585055;CNV;17735411
10;;N;DEL;45457681;46758910;CNV;1301229
10;;N;DEL;125033446;133555381;CNV;8521935
12;;N;DUP;67329;34038577;CNV;33971248
13;;N;DUP;79312312;114325399;CNV;35013087
15;;N;DEL;20360761;52766531;CNV;32405770
16;;N;DUP;24439;21258713;CNV;21234274
16;;N;DUP;21479533;22610699;CNV;1131166
16;;N;DUP;22916268;24911543;CNV;1995275
16;;N;DUP;29359192;29613224;CNV;254032
16;;N;DUP;90096239;90171823;CNV;75584
18;;N;DUP;121261;14090348;CNV;13969087
18;;N;DUP;47835058;80184101;CNV;32349043
19;;N;DUP;7472442;9566875;CNV;2094433
19;;N;DUP;50016064;54508039;CNV;4491975
20;;N;DEL;14895221;14905662;CNV;10441
22;;N;DUP;30668161;50767910;CNV;20099749
14;;N;DUP;103110095;103187758;CNV;77663
11;;N;DEL;5323858;5507333;CNV;183475
13;;N;DUP;25878288;39038435;CNV;13160147
17;;N;DUP;39081043;39766117;CNV;685074
17;;N;DUP;57836346;58005146;CNV;168800
17;;N;DUP;63860745;67991220;CNV;4130475
17;;N;DUP;73207709;78674301;CNV;5466592
17;;N;DUP;78757572;79269400;CNV;511828
2;;N;DUP;91580758;91649071;CNV;68313
5;;N;DUP;70481377;72159957;CNV;1678580
1;;N;DUP;156068369;156111093;CNV;42724
7;;N;DUP;74783555;75417313;CNV;633758
8;;N;DUP;47974925;48428406;CNV;453481
8;;N;DUP;69837711;69938311;CNV;100600
10;;N;DEL;61025977;62193705;CNV;1167728
11;;N;DUP;127005132;127271114;CNV;265982
3;;N;DUP;136730827;136754596;CNV;23769
15;;N;DEL;20360761;20729900;CNV;369139
4;;N;DEL;86985;49503795;CNV;49416810
4;;N;DUP;49530627;57465835;CNV;7935208
4;;N;DEL;62072120;78543505;CNV;16471385
4;;N;DEL;83462554;109710359;CNV;26247805
5;;N;DUP;184359;45262655;CNV;45078296
5;;N;DEL;50396509;70867807;CNV;20471298
5;;N;DEL;70931967;71095694;CNV;163727
5;;N;DEL;71100194;115125020;CNV;44024826
6;;N;DUP;186414;61901295;CNV;61714881
8;;N;DUP;43029009;145053383;CNV;102024374
10;;N;DUP;173180;32958824;CNV;32785644
11;;N;DUP;33669465;36648055;CNV;2978590
15;;N;DEL;20360761;43531564;CNV;23170803
15;;N;DEL;44410548;45403467;CNV;992919
15;;N;DUP;95501550;99497872;CNV;3996322
22;;N;DUP;19850367;20115409;CNV;265042
6;;N;DUP;110101871;110219768;CNV;117897
11;;N;DUP;33057177;35286890;CNV;2229713
16;;N;DUP;3948580;14126825;CNV;10178245
1;;N;DUP;54200559;55216976;CNV;1016417
3;;N;DUP;8733914;10150229;CNV;1416315
3;;N;DEL;78598050;93884766;CNV;15286716
3;;N;DUP;94015026;95654658;CNV;1639632
6;;N;DUP;186414;351224;CNV;164810
7;;N;DUP;8262747;20311166;CNV;12048419
8;;N;DEL;197738;32760376;CNV;32562638
8;;N;DUP;41750324;46850704;CNV;5100380
8;;N;DUP;47191636;47774266;CNV;582630
8;;N;DUP;47974925;57364680;CNV;9389755
8;;N;DUP;57748163;143366738;CNV;85618575
8;;N;DUP;143376557;145053383;CNV;1676826
10;;N;DUP;43454484;53546498;CNV;10092014
10;;N;DUP;70266184;71645950;CNV;1379766
10;;N;DUP;73530244;74725449;CNV;1195205
10;;N;DUP;76553376;78252203;CNV;1698827
11;;N;DEL;124923369;134480876;CNV;9557507
12;;N;DUP;67329;190314;CNV;122985
12;;N;DUP;65465797;72663768;CNV;7197971
15;;N;DUP;63588887;64867938;CNV;1279051
15;;N;DUP;70963815;72751639;CNV;1787824
15;;N;DUP;73289198;73739963;CNV;450765
16;;N;DUP;47669343;49299419;CNV;1630076
17;;N;DUP;32656474;32767665;CNV;111191
17;;N;DUP;38402192;39977193;CNV;1575001
19;;N;DUP;3546130;3575606;CNV;29476
3;;N;DEL;75730182;75738730;CNV;8548
11;;N;DUP;74254099;74267227;CNV;13128
12;;N;DUP;6820733;6825639;CNV;4906
17;;N;DUP;19189814;19219736;CNV;29922
17;;N;DUP;27078631;28881308;CNV;1802677
17;;N;DUP;28898008;29645242;CNV;747234
17;;N;DUP;30092078;31317813;CNV;1225735
17;;N;DUP;34639228;35578153;CNV;938925
17;;N;DEL;35679515;35745666;CNV;66151
17;;N;DUP;36495340;38542418;CNV;2047078
17;;N;DUP;39211713;39923144;CNV;711431
17;;N;DUP;41046754;41177688;CNV;130934
20;;N;DUP;23083907;24543484;CNV;1459577
1;;N;DEL;8012066;8018961;CNV;6895
1;;N;DUP;232727335;248917362;CNV;16190027
3;;N;DEL;195694980;195714957;CNV;19977
6;;N;DUP;12008467;25318345;CNV;13309878
8;;N;DUP;95247123;145053383;CNV;49806260
9;;N;DEL;21862345;23765052;CNV;1902707
15;;N;DUP;92500807;101654591;CNV;9153784
7;;N;DEL;102647347;102678631;CNV;31284
8;;N;DUP;67264;145053383;CNV;144986119
5;;N;DUP;11278197;11818296;CNV;540099
8;;N;DUP;55311412;145053383;CNV;89741971
17;;N;DUP;15651296;21149418;CNV;5498122
17;;N;DUP;27431345;28573267;CNV;1141922
17;;N;DUP;38738416;41238284;CNV;2499868
17;;N;DUP;43015056;44674029;CNV;1658973
17;;N;DUP;73207709;75371382;CNV;2163673
17;;N;DUP;82153824;82906022;CNV;752198
17;;N;DEL;82944006;83094727;CNV;150721
22;;N;DEL;37010968;37066916;CNV;55948
1;;N;DEL;161305947;161362581;CNV;56634
1;;N;DEL;197917951;198253135;CNV;335184
7;;N;DEL;100211478;100221409;CNV;9931
2;;N;DUP;159236083;174428110;CNV;15192027
6;;N;DUP;12296183;12759279;CNV;463096
8;;N;DUP;7712897;7934441;CNV;221544
8;;N;DUP;94547629;145053383;CNV;50505754
9;;N;DUP;29687;19055654;CNV;19025967
9;;N;DUP;19126227;20330345;CNV;1204118
9;;N;DUP;20363531;33047334;CNV;12683803
10;;N;DUP;119167922;119944529;CNV;776607
10;;N;DUP;120575160;121967772;CNV;1392612
13;;N;DEL;18906528;19046644;CNV;140116
16;;N;DUP;80569261;82148501;CNV;1579240
20;;N;DUP;11913434;11926401;CNV;12967
6;;N;DUP;5665390;36112744;CNV;30447354
19;;N;DUP;57540222;57573334;CNV;33112
21;;N;DEL;45278132;46592371;CNV;1314239
5;;N;DUP;1392847;1463232;CNV;70385
8;;N;DUP;86150201;112223319;CNV;26073118
8;;N;DUP;115412949;140700942;CNV;25287993
8;;N;DUP;140821329;145053383;CNV;4232054
9;;N;DUP;74983455;138122002;CNV;63138547
11;;N;DUP;33669465;35286890;CNV;1617425
11;;N;DUP;46597040;47052418;CNV;455378
19;;N;DUP;33206174;36215796;CNV;3009622
21;;N;DUP;10605620;19937188;CNV;9331568
2;;N;DUP;121998205;123850634;CNV;1852429
5;;N;DUP;81401040;81415195;CNV;14155
17;;N;DUP;59253867;60134812;CNV;880945
19;;N;DUP;13073466;13099236;CNV;25770
1;;N;DUP;203217768;205862568;CNV;2644800
6;;N;DUP;3012601;3025141;CNV;12540
6;;N;DUP;10764404;10873620;CNV;109216
8;;N;DUP;31981682;145053383;CNV;113071701
11;;N;DUP;11726346;11913082;CNV;186736
16;;N;DUP;46673574;50224964;CNV;3551390
17;;N;DUP;37392307;38322950;CNV;930643
17;;N;DUP;39201263;39766117;CNV;564854
17;;N;DEL;46024335;46544178;CNV;519843
17;;N;DUP;48530410;49458087;CNV;927677
8;;N;DUP;31981682;103975466;CNV;71993784
8;;N;DUP;103978021;141390368;CNV;37412347
16;;N;DUP;50308755;52280084;CNV;1971329
17;;N;DUP;37392307;38717904;CNV;1325597
17;;N;DUP;38850551;39766117;CNV;915566
17;;N;DEL;46196583;46540700;CNV;344117
2;;N;DUP;21100568;21143545;CNV;42977
2;;N;DUP;91625924;91781562;CNV;155638
4;;N;DUP;153617717;153680455;CNV;62738
15;;N;DUP;81003594;81005324;CNV;1730
16;;N;DEL;35023746;87711270;CNV;52687524
1;;N;DUP;7746030;7779857;CNV;33827
1;;N;DUP;164680110;165501590;CNV;821480
2;;N;DUP;44945058;48308575;CNV;3363517
3;;N;DEL;24053;2925715;CNV;2901662
3;;N;DUP;144218597;157162036;CNV;12943439
3;;N;DUP;165150506;177032905;CNV;11882399
3;;N;DUP;177323002;177752210;CNV;429208
3;;N;DUP;177899148;196936928;CNV;19037780
9;;N;DUP;37079398;37087733;CNV;8335
10;;N;DUP;173180;11049484;CNV;10876304
13;;N;DUP;32432880;33065374;CNV;632494
19;;N;DUP;44426597;44429865;CNV;3268
1;;N;DUP;179953807;180196360;CNV;242553
8;;N;DUP;56217389;145053383;CNV;88835994
17;;N;DUP;38921058;39605638;CNV;684580
17;;N;DUP;39636486;39933142;CNV;296656
17;;N;DEL;46267306;46757275;CNV;489969
20;;N;DUP;34426291;37404350;CNV;2978059
16;;N;DUP;10464595;10483535;CNV;18940
5;;N;DUP;38282461;38477496;CNV;195035
17;;N;DUP;27312332;83094727;CNV;55782395
10;;N;DUP;79612342;79681249;CNV;68907
16;;N;DUP;31711599;33362780;CNV;1651181
3;;N;DUP;112739926;112819797;CNV;79871
9;;N;DEL;34514708;34637306;CNV;122598
15;;N;DEL;20360761;20957703;CNV;596942
17;;N;DEL;7236719;7242281;CNV;5562
1;;N;DUP;90916960;91682583;CNV;765623
1;;N;DUP;91980672;94498634;CNV;2517962
1;;N;DUP;94533182;97129620;CNV;2596438
1;;N;DUP;100292256;109200088;CNV;8907832
1;;N;DUP;159712751;163421254;CNV;3708503
5;;N;DUP;79647910;79670627;CNV;22717
6;;N;DUP;89637798;89840976;CNV;203178
6;;N;DUP;136239764;136365832;CNV;126068
6;;N;DUP;147737381;154458505;CNV;6721124
8;;N;DUP;47774266;55311412;CNV;7537146
8;;N;DUP;55525240;70352899;CNV;14827659
8;;N;DUP;70485457;73291852;CNV;2806395
8;;N;DUP;73322714;76966598;CNV;3643884
8;;N;DUP;76983136;81658209;CNV;4675073
8;;N;DUP;81693938;104420181;CNV;22726243
9;;N;DUP;745935;2045922;CNV;1299987
9;;N;DUP;5462943;5920627;CNV;457684
9;;N;DEL;14720221;27948635;CNV;13228414
9;;N;DUP;33387029;34383894;CNV;996865
9;;N;DUP;34690261;64652314;CNV;29962053
10;;N;DEL;45457681;50336052;CNV;4878371
12;;N;DUP;116533537;116716014;CNV;182477
17;;N;DUP;37392307;37534807;CNV;142500
17;;N;DUP;37613820;38671824;CNV;1058004
17;;N;DUP;38717904;39406759;CNV;688855
17;;N;DUP;39532022;40094047;CNV;562025
17;;N;DUP;60083696;73790144;CNV;13706448
17;;N;DUP;74205554;75004816;CNV;799262
17;;N;DUP;75012800;76949675;CNV;1936875
20;;N;DUP;23083907;23190148;CNV;106241
20;;N;DUP;23336871;23564869;CNV;227998
20;;N;DUP;23602642;31390459;CNV;7787817
22;;N;DUP;20780059;20997422;CNV;217363
2;;N;DUP;197096996;197229078;CNV;132082
2;;N;DUP;200979365;201272727;CNV;293362
2;;N;DUP;201288619;213007612;CNV;11718993
3;;N;DEL;47850055;57445301;CNV;9595246
8;;N;DUP;92984744;103975466;CNV;10990722
8;;N;DUP;103978021;120036940;CNV;16058919
8;;N;DUP;120049792;120518767;CNV;468975
8;;N;DUP;120538201;138132534;CNV;17594333
13;;N;DEL;18906528;19173813;CNV;267285
16;;N;DUP;2737512;2770382;CNV;32870
18;;N;DUP;61555008;80184101;CNV;18629093
22;;N;DUP;35667665;41633769;CNV;5966104
22;;N;DUP;39521185;39529155;CNV;7970
2;;N;DEL;145023218;145874673;CNV;851455
7;;N;DEL;100676756;100681428;CNV;4672
7;;N;DEL;123877343;124743913;CNV;866570
7;;N;DEL;139052035;139070183;CNV;18148
9;;N;DEL;93516216;93679251;CNV;163035
14;;N;DUP;105050604;105142397;CNV;91793
16;;N;DEL;31426083;31428098;CNV;2015
16;;N;DEL;31436859;68013737;CNV;36576878
16;;N;DEL;68022292;68191278;CNV;168986
16;;N;DEL;68229458;90171823;CNV;21942365
17;;N;DEL;59731492;59784971;CNV;53479
20;;N;DEL;32443399;32450030;CNV;6631
1;;N;DEL;973545;1218885;CNV;245340
2;;N;DUP;91544300;91649071;CNV;104771
3;;N;DEL;86027920;93884766;CNV;7856846
5;;N;DEL;45262655;80654798;CNV;35392143
5;;N;DUP;177723433;177892216;CNV;168783
7;;N;DUP;44008932;44014753;CNV;5821
7;;N;DUP;67237915;73686699;CNV;6448784
7;;N;DUP;77011954;77040025;CNV;28071
7;;N;DUP;99968384;100089370;CNV;120986
7;;N;DUP;144269467;150044897;CNV;5775430
7;;N;DUP;151383995;151857016;CNV;473021
17;;N;DUP;183950;763780;CNV;579830
17;;N;DUP;38445581;40278375;CNV;1832794
18;;N;DUP;32266403;32287314;CNV;20911
16;;N;DEL;30739288;31083693;CNV;344405
2;;N;DUP;206017774;206116380;CNV;98606
2;;N;DUP;235746580;235868531;CNV;121951
7;;N;DUP;137876456;137928336;CNV;51880
17;;N;DEL;39653719;39723615;CNV;69896
1;;N;DEL;78629749;119033062;CNV;40403313
1;;N;DUP;160685079;248917362;CNV;88232283
3;;N;DEL;41236429;66369510;CNV;25133081
3;;N;DEL;71570394;74512461;CNV;2942067
3;;N;DEL;76341387;88141836;CNV;11800449
4;;N;DUP;1814428;1942376;CNV;127948
8;;N;DUP;35672475;39082670;CNV;3410195
8;;N;DUP;98093336;104420181;CNV;6326845
9;;N;DUP;29687;7128206;CNV;7098519
9;;N;DEL;7798572;62475510;CNV;54676938
9;;N;DEL;110169516;138122002;CNV;27952486
11;;N;DEL;108565469;134480876;CNV;25915407
17;;N;DUP;27078631;27765684;CNV;687053
17;;N;DUP;27879317;28898008;CNV;1018691
17;;N;DUP;28906938;29572616;CNV;665678
17;;N;DUP;38445581;39730241;CNV;1284660
17;;N;DUP;48026240;49513428;CNV;1487188
17;;N;DUP;50474605;51747780;CNV;1273175
18;;N;DEL;121261;80184101;CNV;80062840
19;;N;DUP;44108227;44886330;CNV;778103
19;;N;DUP;45614664;45890609;CNV;275945
19;;N;DUP;49054477;49906933;CNV;852456
19;;N;DUP;49930817;50154668;CNV;223851
19;;N;DUP;50309904;50798700;CNV;488796
19;;N;DUP;50818701;50825427;CNV;6726
19;;N;DUP;50860440;51411101;CNV;550661
19;;N;DUP;51451677;51646348;CNV;194671
19;;N;DUP;51704445;53238441;CNV;1533996
19;;N;DUP;53290900;53495867;CNV;204967
19;;N;DUP;53521986;55429176;CNV;1907190
19;;N;DUP;55456397;56160341;CNV;703944
19;;N;DUP;56185336;56663542;CNV;478206
19;;N;DUP;56791175;58554158;CNV;1762983
19;;N;DUP;58557113;58581425;CNV;24312
20;;N;DUP;96331;3777536;CNV;3681205
1;;N;DUP;149851106;248917362;CNV;99066256
6;;N;DEL;186414;5771327;CNV;5584913
6;;N;DEL;10932424;13979001;CNV;3046577
6;;N;DUP;28591353;28859889;CNV;268536
6;;N;DEL;73971766;83553473;CNV;9581707
6;;N;DUP;83909059;84055367;CNV;146308
6;;N;DEL;84125018;88769826;CNV;4644808
6;;N;DEL;167296130;170577603;CNV;3281473
12;;N;DUP;62602037;62616828;CNV;14791
14;;N;DEL;19271020;24819114;CNV;5548094
22;;N;DEL;15813422;49572771;CNV;33759349
6;;N;DUP;63281110;65787912;CNV;2506802
6;;N;DEL;67888053;121113104;CNV;53225051
6;;N;DEL;142445728;151353231;CNV;8907503
6;;N;DEL;158792053;170577603;CNV;11785550
7;;N;DUP;143812466;143960518;CNV;148052
7;;N;DEL;144259170;146149588;CNV;1890418
8;;N;DEL;38852193;46850704;CNV;7998511
11;;N;DEL;90163377;134480876;CNV;44317499
13;;N;DUP;43214071;49914693;CNV;6700622
14;;N;DUP;49571083;50434498;CNV;863415
14;;N;DEL;50591609;50739446;CNV;147837
14;;N;DUP;50880516;53054467;CNV;2173951
14;;N;DUP;60245613;60511531;CNV;265918
14;;N;DUP;80211952;80496614;CNV;284662
17;;N;DEL;183950;27312332;CNV;27128382
17;;N;DUP;41984655;42311808;CNV;327153
17;;N;DUP;48707166;49458087;CNV;750921
17;;N;DUP;56791994;57488453;CNV;696459
17;;N;DUP;67340195;67938253;CNV;598058
17;;N;DUP;74205554;74694569;CNV;489015
17;;N;DUP;80997310;83094727;CNV;2097417
20;;N;DEL;16378885;16731705;CNV;352820
21;;N;DUP;10605620;14108994;CNV;3503374
21;;N;DEL;14144242;15346696;CNV;1202454
21;;N;DUP;15878424;21080787;CNV;5202363
21;;N;DEL;45100620;46132197;CNV;1031577
1;;N;DUP;146017538;184806013;CNV;38788475
7;;N;DEL;112766632;114691736;CNV;1925104
11;;N;DEL;21370904;24520677;CNV;3149773
16;;N;DUP;53328962;55488686;CNV;2159724
3;;N;DEL;24053;74263301;CNV;74239248
3;;N;DUP;85008503;86496278;CNV;1487775
4;;N;DEL;86985;190089947;CNV;190002962
5;;N;DEL;53671769;70867807;CNV;17196038
5;;N;DEL;70931967;71111518;CNV;179551
5;;N;DEL;71189834;135444429;CNV;64254595
5;;N;DUP;140537555;141318908;CNV;781353
5;;N;DEL;141427369;141512058;CNV;84689
5;;N;DUP;141516921;142820237;CNV;1303316
5;;N;DUP;148123892;149413749;CNV;1289857
5;;N;DUP;152270362;154880376;CNV;2610014
5;;N;DEL;154888251;181275946;CNV;26387695
6;;N;DUP;89840976;93410644;CNV;3569668
6;;N;DUP;94398319;106323616;CNV;11925297
6;;N;DUP;106568649;107040200;CNV;471551
7;;N;DUP;97022325;97732699;CNV;710374
7;;N;DEL;116260200;159028254;CNV;42768054
8;;N;DEL;67264;43201670;CNV;43134406
8;;N;DUP;46260814;145053383;CNV;98792569
10;;N;DEL;173180;2446854;CNV;2273674
10;;N;DUP;3135785;7799019;CNV;4663234
11;;N;DEL;199994;32605218;CNV;32405224
11;;N;DUP;32830560;38013678;CNV;5183118
11;;N;DUP;64349975;65122333;CNV;772358
11;;N;DUP;65127612;68058794;CNV;2931182
11;;N;DUP;68158433;69005216;CNV;846783
11;;N;DUP;69018039;70207323;CNV;1189284
11;;N;DUP;70375005;70468420;CNV;93415
11;;N;DEL;70564624;122115575;CNV;51550951
11;;N;DUP;122152269;122656172;CNV;503903
11;;N;DEL;122872587;129617196;CNV;6744609
11;;N;DEL;129697845;134480876;CNV;4783031
12;;N;DEL;38589362;56663799;CNV;18074437
12;;N;DUP;56752283;57526743;CNV;774460
12;;N;DUP;57535113;57941858;CNV;406745
12;;N;DUP;58095054;58566224;CNV;471170
12;;N;DEL;66138041;68856223;CNV;2718182
12;;N;DUP;69241414;71664259;CNV;2422845
12;;N;DEL;71699072;129113198;CNV;57414126
12;;N;DUP;130808660;133202201;CNV;2393541
14;;N;DUP;19271020;106504425;CNV;87233405
17;;N;DUP;41611115;41624280;CNV;13165
18;;N;DEL;43103123;50393527;CNV;7290404
18;;N;DEL;55482846;80184101;CNV;24701255
19;;N;DEL;288125;23754860;CNV;23466735
1;;N;DEL;212619502;212836018;CNV;216516
5;;N;DUP;9285278;9297914;CNV;12636
5;;N;DEL;70931967;71195398;CNV;263431
8;;N;DUP;25243717;25504588;CNV;260871
8;;N;DUP;32760376;35794423;CNV;3034047
8;;N;DUP;38988027;42331493;CNV;3343466
8;;N;DUP;42371629;43129845;CNV;758216
16;;N;DEL;21589845;21641557;CNV;51712
16;;N;DUP;31703297;35197322;CNV;3494025
3;;N;DUP;128807572;129502827;CNV;695255
3;;N;DUP;140058008;151549391;CNV;11491383
5;;N;DEL;70867807;72443552;CNV;1575745
5;;N;DEL;81207295;81401040;CNV;193745
6;;N;DEL;31884728;32846170;CNV;961442
6;;N;DEL;36308445;50751251;CNV;14442806
8;;N;DEL;1619799;33500918;CNV;31881119
8;;N;DUP;40154217;48061597;CNV;7907380
8;;N;DUP;48428406;142270920;CNV;93842514
8;;N;DUP;142300600;145053383;CNV;2752783
9;;N;DUP;69819856;70170519;CNV;350663
11;;N;DUP;66665077;66689911;CNV;24834
12;;N;DUP;4912831;6539601;CNV;1626770
12;;N;DUP;6560176;6750248;CNV;190072
12;;N;DEL;9753109;26120919;CNV;16367810
12;;N;DEL;64194043;66310576;CNV;2116533
15;;N;DEL;20360761;35858055;CNV;15497294
16;;N;DUP;85779779;85806857;CNV;27078
17;;N;DEL;8289014;22413172;CNV;14124158
20;;N;DUP;40687528;41514866;CNV;827338
20;;N;DUP;49289007;54219569;CNV;4930562
20;;N;DUP;64162011;64265396;CNV;103385
21;;N;DEL;34823783;36743464;CNV;1919681
21;;N;DEL;38054150;40052034;CNV;1997884
1;;N;DUP;149859124;151243716;CNV;1384592
3;;N;DEL;24053;198038635;CNV;198014582
7;;N;DUP;4265960;4754531;CNV;488571
7;;N;DUP;6154977;23387575;CNV;17232598
7;;N;DUP;23491345;71713522;CNV;48222177
7;;N;DUP;71783142;73686699;CNV;1903557
7;;N;DUP;73699322;74534186;CNV;834864
7;;N;DUP;74602442;75061243;CNV;458801
7;;N;DUP;75367516;76626979;CNV;1259463
7;;N;DUP;76637576;79462700;CNV;2825124
7;;N;DUP;80090546;88797763;CNV;8707217
7;;N;DEL;89334346;91873933;CNV;2539587
7;;N;DUP;92107360;92917151;CNV;809791
7;;N;DEL;93100334;101315083;CNV;8214749
7;;N;DUP;101449424;101836177;CNV;386753
7;;N;DEL;101960787;127704907;CNV;25744120
7;;N;DUP;127999207;132484847;CNV;4485640
7;;N;DEL;132728727;133041807;CNV;313080
7;;N;DUP;133376834;133691287;CNV;314453
7;;N;DEL;133761948;149070320;CNV;15308372
7;;N;DUP;149103059;149488082;CNV;385023
7;;N;DEL;149547316;154242962;CNV;4695646
7;;N;DUP;154893381;158631671;CNV;3738290
7;;N;DEL;158731199;159028254;CNV;297055
8;;N;DEL;7007236;8703984;CNV;1696748
9;;N;DEL;72354979;77423850;CNV;5068871
12;;N;DEL;11267205;15111373;CNV;3844168
13;;N;DEL;18906528;66617143;CNV;47710615
13;;N;DEL;72888863;75605778;CNV;2716915
17;;N;DEL;183950;7114206;CNV;6930256
17;;N;DEL;7174037;7191328;CNV;17291
17;;N;DEL;7221635;22266332;CNV;15044697
17;;N;DEL;29544441;35441013;CNV;5896572
19;;N;DEL;35279460;36183526;CNV;904066
8;;N;DEL;187249;36452849;CNV;36265600
8;;N;DUP;36888674;145053383;CNV;108164709
16;;N;DEL;35023746;56625765;CNV;21602019
16;;N;DUP;56653064;56666876;CNV;13812
16;;N;DEL;56671014;90171823;CNV;33500809
13;;N;DUP;106543705;106630914;CNV;87209
16;;N;DUP;80976044;81962291;CNV;986247
17;;N;DUP;47808580;48133623;CNV;325043
17;;N;DUP;50531388;51747780;CNV;1216392
17;;N;DUP;55326116;56594656;CNV;1268540
17;;N;DUP;59253867;60663396;CNV;1409529
19;;N;DUP;11738864;11781921;CNV;43057
1;;N;DUP;156135935;156156469;CNV;20534
1;;N;DEL;202521109;202588177;CNV;67068
17;;N;DUP;39405531;39933142;CNV;527611
5;;N;DEL;176389624;177093701;CNV;704077
8;;N;DUP;7007236;7896517;CNV;889281
19;;N;DUP;14566234;14622537;CNV;56303
11;;N;DUP;117201870;117411882;CNV;210012
21;;N;DEL;44348134;44456852;CNV;108718
5;;N;DUP;9121838;9131928;CNV;10090
5;;N;DUP;10366422;10396854;CNV;30432
8;;N;DUP;41262472;145053383;CNV;103790911
9;;N;DUP;87532820;87708225;CNV;175405
11;;N;DUP;70207323;70375005;CNV;167682
11;;N;DUP;125088463;125097090;CNV;8627
14;;N;DUP;37285370;37385526;CNV;100156
14;;N;DUP;81270725;81498443;CNV;227718
7;;N;DUP;20663116;41133444;CNV;20470328
7;;N;DUP;98629812;99548249;CNV;918437
8;;N;DEL;7822046;7934441;CNV;112395
8;;N;DUP;27241227;28158603;CNV;917376
8;;N;DUP;36452849;61885348;CNV;25432499
8;;N;DUP;86217622;102863914;CNV;16646292
8;;N;DUP;115533996;116298741;CNV;764745
8;;N;DUP;122127144;125255878;CNV;3128734
1;;N;DUP;16535127;16630205;CNV;95078
13;;N;DUP;95479864;95522497;CNV;42633
1;;N;DUP;120953133;248917362;CNV;127964229
3;;N;DEL;50290589;50341198;CNV;50609
8;;N;DEL;197738;30635087;CNV;30437349
8;;N;DUP;30679620;145053383;CNV;114373763
9;;N;DEL;78278030;107487325;CNV;29209295
10;;N;DEL;78040285;94338667;CNV;16298382
11;;N;DEL;199994;27217410;CNV;27017416
11;;N;DEL;103050997;134480876;CNV;31429879
16;;N;DEL;15594809;15866904;CNV;272095
16;;N;DEL;46697583;90057144;CNV;43359561
17;;N;DEL;183950;16553313;CNV;16369363
21;;N;DEL;16344274;16618983;CNV;274709
21;;N;DEL;18266130;46654410;CNV;28388280
16;;N;DUP;46673574;47162607;CNV;489033
5;;N;DUP;184359;9152035;CNV;8967676
5;;N;DUP;9157330;9196882;CNV;39552
5;;N;DUP;9199605;50396509;CNV;41196904
6;;N;DUP;31401483;31717654;CNV;316171
6;;N;DUP;43505432;44553083;CNV;1047651
7;;N;DUP;54570859;54759204;CNV;188345
7;;N;DUP;55027831;55211095;CNV;183264
8;;N;DEL;67264;35525606;CNV;35458342
8;;N;DUP;35672475;35794423;CNV;121948
8;;N;DUP;36452849;40530695;CNV;4077846
10;;N;DUP;3750516;5105635;CNV;1355119
10;;N;DUP;5196865;17229822;CNV;12032957
11;;N;DUP;69416390;70436467;CNV;1020077
15;;N;DEL;50362597;50369372;CNV;6775
18;;N;DUP;54287351;57029651;CNV;2742300
18;;N;DUP;57710397;59435959;CNV;1725562
19;;N;DUP;17049866;17216026;CNV;166160
20;;N;DUP;26187373;34596140;CNV;8408767
20;;N;DUP;41360030;57613202;CNV;16253172
20;;N;DUP;57648660;64265396;CNV;6616736
4;;N;DUP;46735200;47914620;CNV;1179420
8;;N;DUP;37735151;43129845;CNV;5394694
21;;N;DUP;13801401;31994327;CNV;18192926
21;;N;DUP;32001863;32495058;CNV;493195
1;;N;DUP;156291656;156292990;CNV;1334
3;;N;DEL;158097857;158713826;CNV;615969
5;;N;DEL;141095839;141641403;CNV;545564
8;;N;DUP;17672101;18222600;CNV;550499
8;;N;DUP;115412949;115963844;CNV;550895
9;;N;DEL;136354499;136495226;CNV;140727
12;;N;DUP;57614740;59789653;CNV;2174913
17;;N;DUP;39081043;39923144;CNV;842101
2;;N;DEL;99821829;131066621;CNV;31244792
2;;N;DEL;132645540;242088078;CNV;109442538
7;;N;DEL;63917882;152648847;CNV;88730965
7;;N;DUP;152854634;156683080;CNV;3828446
8;;N;DUP;6447103;13568181;CNV;7121078
8;;N;DUP;36452849;38060004;CNV;1607155
8;;N;DUP;38063548;41962575;CNV;3899027
8;;N;DUP;69402310;140700942;CNV;71298632
9;;N;DEL;213621;36952779;CNV;36739158
11;;N;DEL;199994;12358743;CNV;12158749
11;;N;DUP;68555598;77609468;CNV;9053870
11;;N;DUP;77616359;80834989;CNV;3218630
11;;N;DUP;82732199;83168635;CNV;436436
11;;N;DEL;83191113;134480876;CNV;51289763
13;;N;DUP;29484987;30631922;CNV;1146935
13;;N;DEL;30657938;91486795;CNV;60828857
16;;N;DEL;30739288;90171823;CNV;59432535
17;;N;DEL;183950;19743278;CNV;19559328
18;;N;DUP;121261;14831415;CNV;14710154
18;;N;DEL;20947772;26133974;CNV;5186202
18;;N;DUP;26390607;39207941;CNV;12817334
18;;N;DEL;40099069;80184101;CNV;40085032
19;;N;DUP;51500137;55695226;CNV;4195089
19;;N;DUP;55707542;58005936;CNV;2298394
19;;N;DEL;58037949;58581425;CNV;543476
2;;N;DUP;238239186;238245400;CNV;6214
3;;N;DUP;9459441;9498846;CNV;39405
7;;N;DEL;128304399;128313204;CNV;8805
8;;N;DEL;245225;11861436;CNV;11616211
8;;N;DUP;12172025;12606776;CNV;434751
8;;N;DEL;12722445;24508599;CNV;11786154
8;;N;DUP;24917763;24953759;CNV;35996
8;;N;DEL;25243717;43201670;CNV;17957953
11;;N;DEL;57038197;66480068;CNV;9441871
11;;N;DUP;66521306;72955037;CNV;6433731
11;;N;DUP;76657956;77609468;CNV;951512
16;;N;DUP;24439;35786613;CNV;35762174
16;;N;DUP;87888129;88248873;CNV;360744
17;;N;DUP;16621302;17549761;CNV;928459
17;;N;DUP;18422866;19132709;CNV;709843
17;;N;DUP;19142124;19219736;CNV;77612
17;;N;DUP;19290647;19578574;CNV;287927
17;;N;DUP;28328554;36013206;CNV;7684652
17;;N;DUP;37237243;40225627;CNV;2988384
1;;N;DEL;192659454;192809129;CNV;149675
8;;N;DEL;16108794;16993178;CNV;884384
6;;N;DUP;106568649;109010024;CNV;2441375
8;;N;DUP;38063548;39082670;CNV;1019122
13;;N;DUP;28700269;29484987;CNV;784718
17;;N;DUP;37843197;39929536;CNV;2086339
17;;N;DUP;3673399;3714809;CNV;41410
7;;N;DEL;140024020;140085156;CNV;61136
8;;N;DUP;39903945;142208551;CNV;102304606
20;;N;DEL;3649228;3923727;CNV;274499
12;;N;DUP;67329;220767;CNV;153438
19;;N;DEL;21057861;23786171;CNV;2728310
3;;N;DEL;50196483;50263141;CNV;66658
3;;N;DEL;158097857;158672476;CNV;574619
8;;N;DUP;39766907;43129845;CNV;3362938
8;;N;DUP;43201670;145053383;CNV;101851713
11;;N;DUP;77609468;79423706;CNV;1814238
1;;N;DUP;6591047;6653981;CNV;62934
2;;N;DUP;95087544;95149824;CNV;62280
13;;N;DUP;19677771;19837791;CNV;160020
16;;N;DEL;30739288;31091287;CNV;351999
17;;N;DUP;36940486;40390040;CNV;3449554
17;;N;DUP;66809327;67692669;CNV;883342
17;;N;DUP;74521231;75794023;CNV;1272792
20;;N;DUP;11810319;13300083;CNV;1489764
1;;N;DUP;43365593;45638002;CNV;2272409
1;;N;DEL;45691011;50201339;CNV;4510328
1;;N;DUP;50418784;50439742;CNV;20958
1;;N;DUP;200043838;206015955;CNV;5972117
1;;N;DUP;206345391;206544579;CNV;199188
1;;N;DUP;206589103;220805238;CNV;14216135
1;;N;DUP;220832293;235548055;CNV;14715762
3;;N;DUP;3849612;4362003;CNV;512391
3;;N;DEL;75730182;75769378;CNV;39196
4;;N;DUP;87663895;176327206;CNV;88663311
7;;N;DUP;13988143;16134605;CNV;2146462
7;;N;DUP;16269425;21446257;CNV;5176832
7;;N;DUP;21511480;21514396;CNV;2916
7;;N;DUP;25658008;27100824;CNV;1442816
11;;N;DUP;27827255;28077121;CNV;249866
11;;N;DUP;28130007;31783430;CNV;3653423
11;;N;DUP;31789966;33085081;CNV;1295115
11;;N;DUP;33170464;45242127;CNV;12071663
11;;N;DUP;71092499;71538589;CNV;446090
11;;N;DUP;72838210;74904091;CNV;2065881
14;;N;DUP;23412786;23521172;CNV;108386
15;;N;DEL;20360761;29117415;CNV;8756654
17;;N;DUP;29492848;30092078;CNV;599230
17;;N;DUP;38402192;38530200;CNV;128008
17;;N;DUP;38542418;39406759;CNV;864341
17;;N;DUP;49046292;49974117;CNV;927825
17;;N;DUP;49991768;51323664;CNV;1331896
17;;N;DUP;58089266;58301550;CNV;212284
17;;N;DUP;58692655;59131336;CNV;438681
17;;N;DUP;59195378;59784971;CNV;589593
17;;N;DUP;59860366;60431272;CNV;570906
17;;N;DUP;63433327;64482955;CNV;1049628
17;;N;DUP;64502476;66884601;CNV;2382125
17;;N;DUP;67033325;67743991;CNV;710666
18;;N;DUP;23536723;23600344;CNV;63621
20;;N;DUP;51832065;56452715;CNV;4620650
20;;N;DUP;56518152;63934403;CNV;7416251
3;;N;DUP;122362997;122536239;CNV;173242
8;;N;DUP;17655937;17997605;CNV;341668
8;;N;DUP;29140573;38326808;CNV;9186235
8;;N;DUP;38408435;42752761;CNV;4344326
8;;N;DUP;56518675;140031179;CNV;83512504
8;;N;DUP;140102783;145053383;CNV;4950600
14;;N;DUP;45706320;50091594;CNV;4385274
16;;N;DUP;47128368;50224964;CNV;3096596
16;;N;DEL;50308755;50633926;CNV;325171
19;;N;DUP;51589606;51704445;CNV;114839
8;;N;DEL;7712897;7934441;CNV;221544
1;;N;DEL;8007910;8012066;CNV;4156
5;;N;DUP;36194516;36668891;CNV;474375
6;;N;DUP;29791288;29830909;CNV;39621
10;;N;DUP;85602521;85647902;CNV;45381
10;;N;DUP;101555909;101580343;CNV;24434
11;;N;DUP;73401413;75801463;CNV;2400050
11;;N;DEL;76142060;76782801;CNV;640741
11;;N;DUP;76796424;79423706;CNV;2627282
14;;N;DUP;58209028;58372510;CNV;163482
14;;N;DUP;58410872;60098492;CNV;1687620
17;;N;DUP;59683910;59697409;CNV;13499
22;;N;DUP;19763286;19854478;CNV;91192
22;;N;DEL;49963953;49993044;CNV;29091
1;;N;DUP;183461808;185293271;CNV;1831463
1;;N;DUP;185301114;198529120;CNV;13228006
1;;N;DUP;198756093;235346862;CNV;36590769
1;;N;DUP;235441849;248917362;CNV;13475513
3;;N;DUP;148845530;151326551;CNV;2481021
3;;N;DUP;153163137;156538504;CNV;3375367
5;;N;DUP;28926135;31251610;CNV;2325475
5;;N;DUP;96748547;111316579;CNV;14568032
5;;N;DEL;111484408;116214167;CNV;4729759
5;;N;DUP;137753746;138304964;CNV;551218
5;;N;DUP;141863602;143279850;CNV;1416248
6;;N;DUP;136260228;141581714;CNV;5321486
8;;N;DEL;245225;35794423;CNV;35549198
8;;N;DEL;39323016;47191636;CNV;7868620
9;;N;DUP;34996667;35106379;CNV;109712
9;;N;DUP;35361225;36360641;CNV;999416
9;;N;DUP;36599423;38567278;CNV;1967855
10;;N;DUP;12246239;14972797;CNV;2726558
10;;N;DEL;106809481;114163034;CNV;7353553
11;;N;DUP;32957972;35286890;CNV;2328918
14;;N;DUP;56270812;58298071;CNV;2027259
14;;N;DUP;59607462;61518396;CNV;1910934
14;;N;DUP;61653794;64746338;CNV;3092544
14;;N;DUP;87933951;106504425;CNV;18570474
17;;N;DEL;3565640;27078631;CNV;23512991
18;;N;DUP;22413758;24451580;CNV;2037822
18;;N;DUP;34866919;35339940;CNV;473021
18;;N;DUP;42974107;45682747;CNV;2708640
18;;N;DEL;45691850;45984342;CNV;292492
18;;N;DUP;46105338;46460331;CNV;354993
1;;N;DUP;160996382;161153971;CNV;157589
5;;N;DUP;107378629;107387740;CNV;9111
9;;N;DUP;213621;19516131;CNV;19302510
9;;N;DUP;20330345;21454798;CNV;1124453
12;;N;DUP;18505344;25204953;CNV;6699609
12;;N;DUP;25225674;27724145;CNV;2498471
12;;N;DUP;27802658;31073340;CNV;3270682
14;;N;DUP;68099516;68586434;CNV;486918
20;;N;DEL;1446473;2463827;CNV;1017354
1;;N;DUP;149884759;149887213;CNV;2454
1;;N;DUP;197159615;197421888;CNV;262273
5;;N;DUP;184359;45259916;CNV;45075557
5;;N;DUP;113534371;113604421;CNV;70050
6;;N;DUP;93410644;109431221;CNV;16020577
10;;N;DUP;173180;86435517;CNV;86262337
13;;N;DUP;18906528;22276034;CNV;3369506
13;;N;DUP;22820939;24959616;CNV;2138677
13;;N;DUP;28300712;30255511;CNV;1954799
17;;N;DUP;28494453;31024231;CNV;2529778
17;;N;DUP;38491455;40278375;CNV;1786920
17;;N;DUP;73749417;73790144;CNV;40727
11;;N;DUP;34278758;39189386;CNV;4910628
15;;N;DUP;96785550;101654591;CNV;4869041
18;;N;DUP;3453042;3604067;CNV;151025
19;;N;DUP;27776105;36035436;CNV;8259331
19;;N;DUP;36070616;37267612;CNV;1196996
19;;N;DUP;37363496;39836585;CNV;2473089
14;;N;DUP;19271020;23567968;CNV;4296948
21;;N;DEL;14108994;22114799;CNV;8005805
2;;N;DEL;39143;2326436;CNV;2287293
17;;N;DUP;14346571;15239540;CNV;892969
20;;N;DUP;3110668;5197539;CNV;2086871
7;;N;DEL;100972264;101002288;CNV;30024
8;;N;DUP;37963335;145053383;CNV;107090048
7;;N;DUP;99483775;100089370;CNV;605595
7;;N;DUP;100093812;100209191;CNV;115379
11;;N;DUP;77872097;78236825;CNV;364728
16;;N;DUP;51137164;55032723;CNV;3895559
20;;N;DUP;36229590;36256798;CNV;27208
6;;N;DUP;32444757;32444758;CNV;1
11;;N;DEL;60070876;61787554;CNV;1716678
11;;N;DUP;69090483;70207323;CNV;1116840
11;;N;DUP;70375005;70864494;CNV;489489
11;;N;DUP;75204671;78436765;CNV;3232094
4;;N;DUP;785353;836645;CNV;51292
7;;N;DEL;93131571;93308905;CNV;177334
8;;N;DEL;12172025;12414878;CNV;242853
15;;N;DUP;20360761;22015301;CNV;1654540
1;;N;DUP;911484;44541092;CNV;43629608
1;;N;DUP;248438088;248655165;CNV;217077
7;;N;DUP;1494152;3491584;CNV;1997432
7;;N;DEL;3491643;3691004;CNV;199361
7;;N;DUP;117418166;117441426;CNV;23260
9;;N;DEL;1161604;1258510;CNV;96906
10;;N;DUP;68384920;75565499;CNV;7180579
10;;N;DUP;117162851;117258520;CNV;95669
10;;N;DUP;122568455;122574140;CNV;5685
11;;N;DEL;7270138;7307465;CNV;37327
11;;N;DEL;48224784;60626906;CNV;12402122
11;;N;DEL;78754093;99182836;CNV;20428743
11;;N;DEL;99742967;99941160;CNV;198193
11;;N;DEL;103192648;131522794;CNV;28330146
12;;N;DUP;114256;3750610;CNV;3636354
13;;N;DUP;110331692;114267888;CNV;3936196
14;;N;DEL;62532246;62616713;CNV;84467
15;;N;DUP;20743076;23877990;CNV;3134914
15;;N;DEL;24059379;34861661;CNV;10802282
15;;N;DEL;34863204;38307724;CNV;3444520
15;;N;DEL;38593845;101824457;CNV;63230612
17;;N;DEL;10458952;15455352;CNV;4996400
17;;N;DEL;68758594;71515958;CNV;2757364
1;;N;DEL;48017314;50119611;CNV;2102297
1;;N;DEL;82816522;83489939;CNV;673417
1;;N;DEL;187326186;199391849;CNV;12065663
1;;N;DEL;208879207;208953571;CNV;74364
1;;N;DEL;227056783;227997156;CNV;940373
1;;N;DUP;246087532;248655165;CNV;2567633
2;;N;DEL;4225292;4916875;CNV;691583
2;;N;DEL;34040166;34525809;CNV;485643
2;;N;DUP;45815339;45887886;CNV;72547
2;;N;DEL;49287592;52932999;CNV;3645407
2;;N;DUP;108127255;114508979;CNV;6381724
2;;N;DUP;118908386;121480953;CNV;2572567
2;;N;DUP;126569242;128994163;CNV;2424921
2;;N;DEL;146935722;148213046;CNV;1277324
2;;N;DEL;150638026;150641656;CNV;3630
2;;N;DUP;158759252;159226379;CNV;467127
4;;N;DUP;415163;10125607;CNV;9710444
4;;N;DEL;125242526;126734914;CNV;1492388
4;;N;DEL;129108051;137337757;CNV;8229706
5;;N;DUP;207389;45741021;CNV;45533632
6;;N;DUP;14865280;16068339;CNV;1203059
6;;N;DEL;139641050;144113531;CNV;4472481
7;;N;DEL;3651647;3689925;CNV;38278
7;;N;DEL;83510763;90472882;CNV;6962119
7;;N;DUP;137941894;139131167;CNV;1189273
7;;N;DUP;143317151;143593888;CNV;276737
7;;N;DUP;148367794;154377012;CNV;6009218
7;;N;DEL;156135912;157106424;CNV;970512
8;;N;DUP;240568;1019343;CNV;778775
8;;N;DUP;1083625;4430534;CNV;3346909
8;;N;DUP;6094820;13557232;CNV;7462412
8;;N;DEL;14414271;14415891;CNV;1620
8;;N;DUP;16851103;30320453;CNV;13469350
8;;N;DUP;30353003;30517291;CNV;164288
8;;N;DUP;30517734;38806656;CNV;8288922
8;;N;DUP;40192491;46370071;CNV;6177580
8;;N;DUP;46646865;142824280;CNV;96177415
10;;N;DEL;8521883;9060649;CNV;538766
10;;N;DUP;9101481;9288124;CNV;186643
10;;N;DEL;9289964;10479512;CNV;1189548
10;;N;DUP;92411094;93437096;CNV;1026002
12;;N;DEL;1054730;23897683;CNV;22842953
12;;N;DEL;23916186;24101908;CNV;185722
12;;N;DEL;24120489;39639841;CNV;15519352
12;;N;DEL;39902938;40021792;CNV;118854
12;;N;DEL;40096603;45500531;CNV;5403928
12;;N;DEL;45649830;45969244;CNV;319414
12;;N;DEL;46094717;49684341;CNV;3589624
12;;N;DUP;71562233;71572036;CNV;9803
12;;N;DEL;114086628;114457991;CNV;371363
13;;N;DUP;18848939;36588448;CNV;17739509
13;;N;DUP;36692791;37777737;CNV;1084946
13;;N;DUP;38270788;53423205;CNV;15152417
13;;N;DUP;53429368;67499572;CNV;14070204
13;;N;DUP;67505224;85042406;CNV;17537182
13;;N;DUP;85155448;89812266;CNV;4656818
13;;N;DUP;89821719;112570253;CNV;22748534
13;;N;DUP;112593017;114267888;CNV;1674871
14;;N;DEL;19747289;20021979;CNV;274690
14;;N;DEL;62483575;62874078;CNV;390503
14;;N;DEL;79594346;88229366;CNV;8635020
15;;N;DEL;20743076;88859008;CNV;68115932
16;;N;DUP;83459129;89774300;CNV;6315171
17;;N;DEL;601219;11331302;CNV;10730083
17;;N;DEL;11346603;15234289;CNV;3887686
17;;N;DEL;15264658;27131847;CNV;11867189
17;;N;DUP;27132035;41002125;CNV;13870090
17;;N;DUP;41029546;41030673;CNV;1127
17;;N;DUP;41036545;51417448;CNV;10380903
17;;N;DUP;51510889;56501559;CNV;4990670
17;;N;DUP;56535084;58725332;CNV;2190248
17;;N;DUP;59360804;74703694;CNV;15342890
17;;N;DUP;74769076;82630699;CNV;7861623
19;;N;DUP;390341;16518039;CNV;16127698
20;;N;DEL;6444511;8489282;CNV;2044771
20;;N;DUP;17562692;18358849;CNV;796157
20;;N;DUP;31316342;64240906;CNV;32924564
21;;N;DEL;18839710;18841604;CNV;1894
22;;N;DUP;44996489;47794978;CNV;2798489
6;;N;DEL;155295580;155299885;CNV;4305
7;;N;DEL;70786665;70787659;CNV;994
10;;N;DUP;19650313;19650885;CNV;572
16;;N;DEL;3176868;4868325;CNV;1691457
16;;N;DEL;5936664;5937350;CNV;686
16;;N;DEL;85779625;85780274;CNV;649
17;;N;DUP;36110611;36152159;CNV;41548
19;;N;DEL;390341;6685293;CNV;6294952
19;;N;DEL;16345449;20986748;CNV;4641299
20;;N;DEL;61911442;64240906;CNV;2329464
1;;N;DUP;911484;26922154;CNV;26010670
1;;N;DUP;33585836;47796947;CNV;14211111
1;;N;DUP;48017314;69313754;CNV;21296440
1;;N;DUP;75730917;76654692;CNV;923775
1;;N;DUP;85911345;97034043;CNV;11122698
1;;N;DUP;107787734;110631264;CNV;2843530
1;;N;DUP;110712446;153490975;CNV;42778529
1;;N;DUP;153822221;156645402;CNV;2823181
1;;N;DUP;200920591;206778859;CNV;5858268
1;;N;DEL;227056783;227155097;CNV;98314
1;;N;DUP;228090807;237752848;CNV;9662041
1;;N;DUP;247984347;248655165;CNV;670818
2;;N;DUP;110819;3773082;CNV;3662263
2;;N;DEL;4827845;4916448;CNV;88603
2;;N;DEL;7186983;7192667;CNV;5684
2;;N;DUP;8026388;9871488;CNV;1845100
2;;N;DUP;9989983;11524223;CNV;1534240
2;;N;DUP;11552480;34050367;CNV;22497887
2;;N;DEL;34059785;34339519;CNV;279734
2;;N;DUP;34376823;49408096;CNV;15031273
2;;N;DUP;52935796;55915863;CNV;2980067
2;;N;DUP;59833445;75607981;CNV;15774536
2;;N;DUP;108354895;114508979;CNV;6154084
2;;N;DUP;126569242;128776092;CNV;2206850
2;;N;DUP;158759252;159873309;CNV;1114057
2;;N;DUP;215067182;240942225;CNV;25875043
3;;N;DUP;119131;513135;CNV;394004
3;;N;DUP;524278;1151145;CNV;626867
3;;N;DUP;1208626;1907433;CNV;698807
3;;N;DUP;1960118;3677048;CNV;1716930
3;;N;DUP;3707353;5437179;CNV;1729826
3;;N;DUP;5461501;8606810;CNV;3145309
3;;N;DUP;8607776;14260348;CNV;5652572
3;;N;DUP;14638763;21001999;CNV;6363236
3;;N;DUP;21229551;26796842;CNV;5567291
3;;N;DUP;36638588;61967427;CNV;25328839
3;;N;DUP;122776600;130414776;CNV;7638176
3;;N;DUP;137172054;140066680;CNV;2894626
3;;N;DUP;183045792;188885218;CNV;5839426
4;;N;DEL;10125354;15165924;CNV;5040570
4;;N;DEL;15192737;16897131;CNV;1704394
4;;N;DEL;17025174;37360520;CNV;20335346
4;;N;DEL;37367582;38510629;CNV;1143047
4;;N;DEL;38513520;38902960;CNV;389440
4;;N;DEL;38934138;42744607;CNV;3810469
4;;N;DEL;42746247;47135760;CNV;4389513
4;;N;DEL;47140201;57295057;CNV;10154856
4;;N;DEL;57342226;76007275;CNV;18665049
4;;N;DEL;77260250;90818607;CNV;13558357
4;;N;DEL;90819399;92725350;CNV;1905951
4;;N;DEL;92739516;114248280;CNV;21508764
4;;N;DEL;114334122;137337757;CNV;23003635
4;;N;DEL;137338570;189795030;CNV;52456460
5;;N;DUP;207389;19454081;CNV;19246692
5;;N;DUP;31357067;52382816;CNV;21025749
5;;N;DEL;52544586;83689920;CNV;31145334
5;;N;DEL;83730613;129841194;CNV;46110581
5;;N;DEL;129858275;144006419;CNV;14148144
5;;N;DEL;144006449;148546000;CNV;4539551
5;;N;DEL;148560479;152387244;CNV;3826765
5;;N;DEL;152387563;166165005;CNV;13777442
5;;N;DEL;166175872;179177464;CNV;13001592
6;;N;DUP;205610;205878;CNV;268
6;;N;DUP;227752;14828887;CNV;14601135
6;;N;DUP;14865280;15764444;CNV;899164
6;;N;DUP;15823966;16043354;CNV;219388
6;;N;DUP;16047503;16068339;CNV;20836
6;;N;DUP;16077534;18767626;CNV;2690092
6;;N;DUP;23795859;47896376;CNV;24100517
6;;N;DUP;82022453;87524467;CNV;5502014
6;;N;DEL;87661239;106534857;CNV;18873618
6;;N;DEL;106535253;112605802;CNV;6070549
6;;N;DEL;112628587;124776158;CNV;12147571
6;;N;DEL;124839393;126815260;CNV;1975867
6;;N;DEL;126828753;128682304;CNV;1853551
6;;N;DEL;128682935;139747985;CNV;11065050
6;;N;DEL;139909945;156233232;CNV;16323287
6;;N;DEL;156257486;160811739;CNV;4554253
6;;N;DEL;160813015;165620362;CNV;4807347
6;;N;DEL;165652172;170543473;CNV;4891301
7;;N;DUP;1494152;3436912;CNV;1942760
7;;N;DUP;19504876;70787659;CNV;51282783
7;;N;DUP;70844900;78692748;CNV;7847848
7;;N;DUP;78692843;79844275;CNV;1151432
7;;N;DEL;85448995;85565098;CNV;116103
7;;N;DEL;86994672;87000226;CNV;5554
7;;N;DUP;89998396;92997683;CNV;2999287
7;;N;DUP;95316943;108346641;CNV;13029698
7;;N;DUP;110751533;112455567;CNV;1704034
7;;N;DUP;112456737;112457066;CNV;329
7;;N;DUP;126818300;135842895;CNV;9024595
7;;N;DUP;137874944;139131167;CNV;1256223
7;;N;DUP;143317151;144000599;CNV;683448
7;;N;DEL;154398645;154609307;CNV;210662
7;;N;DUP;154609828;159262480;CNV;4652652
8;;N;DUP;240568;277598;CNV;37030
8;;N;DEL;289189;3597214;CNV;3308025
8;;N;DEL;3619761;6018538;CNV;2398777
8;;N;DEL;6023894;14167640;CNV;8143746
8;;N;DEL;14168744;14482032;CNV;313288
8;;N;DEL;14482279;16985253;CNV;2502974
8;;N;DEL;17049616;30870664;CNV;13821048
8;;N;DEL;30923838;33337937;CNV;2414099
8;;N;DUP;33471012;34079464;CNV;608452
8;;N;DUP;34186686;34781359;CNV;594673
8;;N;DUP;35032468;36156306;CNV;1123838
8;;N;DUP;36552470;37496263;CNV;943793
8;;N;DUP;38806656;40190802;CNV;1384146
8;;N;DUP;40192491;43243912;CNV;3051421
8;;N;DUP;43251899;75861613;CNV;32609714
8;;N;DUP;75889295;79585637;CNV;3696342
8;;N;DUP;79699954;82329726;CNV;2629772
8;;N;DUP;82335584;93377336;CNV;11041752
8;;N;DUP;93383784;97834734;CNV;4450950
8;;N;DUP;97853094;97854085;CNV;991
8;;N;DUP;97925921;104459685;CNV;6533764
8;;N;DUP;104634592;107748427;CNV;3113835
8;;N;DUP;107841501;112473987;CNV;4632486
8;;N;DUP;112561308;115985686;CNV;3424378
8;;N;DUP;116015269;135995285;CNV;19980016
8;;N;DUP;135999084;139723632;CNV;3724548
8;;N;DUP;140992798;142824280;CNV;1831482
9;;N;DUP;249391;1156821;CNV;907430
9;;N;DUP;2177391;2211865;CNV;34474
9;;N;DUP;3902435;4104571;CNV;202136
9;;N;DEL;8177428;8179325;CNV;1897
9;;N;DUP;88921435;99377245;CNV;10455810
9;;N;DUP;104709027;116268128;CNV;11559101
9;;N;DEL;116673612;116862396;CNV;188784
9;;N;DUP;119661931;122402946;CNV;2741015
9;;N;DUP;122660586;137995921;CNV;15335335
10;;N;DUP;223755;8492640;CNV;8268885
10;;N;DUP;11084531;50058334;CNV;38973803
10;;N;DUP;64877396;65228859;CNV;351463
10;;N;DUP;67875446;80613760;CNV;12738314
10;;N;DUP;83186670;91817867;CNV;8631197
10;;N;DUP;92411094;93438395;CNV;1027301
10;;N;DUP;93502740;100855411;CNV;7352671
10;;N;DUP;100889027;104510648;CNV;3621621
10;;N;DUP;112314859;133526341;CNV;21211482
11;;N;DEL;1961088;15964026;CNV;14002938
11;;N;DEL;16007548;16463704;CNV;456156
11;;N;DEL;16665767;20679229;CNV;4013462
11;;N;DEL;20819180;31256592;CNV;10437412
11;;N;DEL;31289224;37029137;CNV;5739913
11;;N;DEL;37035012;41333435;CNV;4298423
11;;N;DEL;41363300;60626906;CNV;19263606
11;;N;DEL;78754093;88561067;CNV;9806974
11;;N;DEL;88566116;91800968;CNV;3234852
11;;N;DEL;91863979;95563131;CNV;3699152
11;;N;DEL;95585996;107272411;CNV;11686415
11;;N;DEL;107329705;134707739;CNV;27378034
12;;N;DUP;114256;9378459;CNV;9264203
12;;N;DEL;9511756;9594961;CNV;83205
12;;N;DUP;9694537;16073218;CNV;6378681
12;;N;DUP;24789733;26337222;CNV;1547489
12;;N;DUP;30115471;33117978;CNV;3002507
12;;N;DUP;47343664;58495833;CNV;11152169
12;;N;DUP;91443112;103848267;CNV;12405155
12;;N;DUP;103849443;114040306;CNV;10190863
12;;N;DUP;114780717;114979378;CNV;198661
12;;N;DUP;115518350;132924025;CNV;17405675
13;;N;DUP;18848939;31122365;CNV;12273426
13;;N;DEL;37864597;38261223;CNV;396626
13;;N;DUP;40004281;53178205;CNV;13173924
13;;N;DUP;93968031;100692924;CNV;6724893
14;;N;DUP;19747289;24439060;CNV;4691771
14;;N;DUP;30026513;36720860;CNV;6694347
14;;N;DUP;49167193;62462908;CNV;13295715
14;;N;DEL;62483575;63036147;CNV;552572
14;;N;DUP;63099917;72521938;CNV;9422021
14;;N;DUP;72660294;78010479;CNV;5350185
14;;N;DUP;78040581;79572531;CNV;1531950
14;;N;DUP;88249028;92836758;CNV;4587730
14;;N;DUP;92838889;98512050;CNV;5673161
14;;N;DUP;98558317;106832764;CNV;8274447
15;;N;DEL;23505543;25590829;CNV;2085286
15;;N;DUP;25599004;27172523;CNV;1573519
15;;N;DEL;27178416;29850203;CNV;2671787
15;;N;DUP;29975739;32972107;CNV;2996368
15;;N;DEL;33046889;34087404;CNV;1040515
15;;N;DUP;34349498;34801031;CNV;451533
15;;N;DEL;34860448;35316531;CNV;456083
15;;N;DEL;35394066;37120937;CNV;1726871
15;;N;DEL;37262767;39286679;CNV;2023912
15;;N;DUP;39365445;40148317;CNV;782872
15;;N;DUP;42448171;46154720;CNV;3706549
15;;N;DEL;46218683;46490337;CNV;271654
15;;N;DUP;47707344;48262644;CNV;555300
15;;N;DEL;49427756;49664475;CNV;236719
15;;N;DUP;50110776;53660998;CNV;3550222
15;;N;DEL;54009178;56202938;CNV;2193760
15;;N;DUP;56204327;56527966;CNV;323639
15;;N;DEL;56528827;56944168;CNV;415341
15;;N;DUP;57229954;58015183;CNV;785229
15;;N;DUP;58042147;59004292;CNV;962145
15;;N;DUP;59165177;60066538;CNV;901361
15;;N;DEL;60152523;61608053;CNV;1455530
15;;N;DUP;61668821;61800649;CNV;131828
15;;N;DEL;61977529;62973045;CNV;995516
15;;N;DUP;62989348;67202485;CNV;4213137
15;;N;DUP;67336837;69680619;CNV;2343782
15;;N;DUP;69751044;71829059;CNV;2078015
15;;N;DUP;71976645;77110402;CNV;5133757
15;;N;DUP;77214085;78754943;CNV;1540858
15;;N;DUP;78813878;79304906;CNV;491028
15;;N;DEL;79404359;82586323;CNV;3181964
15;;N;DUP;82778879;83545204;CNV;766325
15;;N;DEL;83582320;83920861;CNV;338541
15;;N;DUP;83922158;86462298;CNV;2540140
15;;N;DEL;86522452;87053526;CNV;531074
15;;N;DUP;87932658;88325070;CNV;392412
15;;N;DUP;88859008;90600488;CNV;1741480
15;;N;DEL;90609113;92042909;CNV;1433796
15;;N;DUP;92193085;94572860;CNV;2379775
15;;N;DEL;94611102;94839034;CNV;227932
15;;N;DUP;94887736;95647302;CNV;759566
15;;N;DEL;95794272;95976903;CNV;182631
15;;N;DUP;95999845;96923607;CNV;923762
15;;N;DEL;96924365;96928573;CNV;4208
15;;N;DUP;96959381;97818830;CNV;859449
15;;N;DUP;100043851;101824457;CNV;1780606
16;;N;DUP;215160;3175868;CNV;2960708
16;;N;DUP;3176868;10063224;CNV;6886356
16;;N;DUP;10070665;12526972;CNV;2456307
16;;N;DEL;13642055;13656867;CNV;14812
16;;N;DUP;13736159;51171908;CNV;37435749
16;;N;DUP;51171914;55734728;CNV;4562814
16;;N;DUP;56064467;59298271;CNV;3233804
16;;N;DUP;64940451;84319977;CNV;19379526
16;;N;DUP;84429919;85786596;CNV;1356677
16;;N;DUP;85890459;89774300;CNV;3883841
17;;N;DEL;11232276;15455352;CNV;4223076
17;;N;DEL;32792144;40849738;CNV;8057594
17;;N;DEL;51510889;56501559;CNV;4990670
17;;N;DEL;56535084;68937660;CNV;12402576
17;;N;DEL;69092801;71515958;CNV;2423157
17;;N;DEL;71664926;74652981;CNV;2988055
18;;N;DEL;159885;7851734;CNV;7691849
18;;N;DEL;7852014;22499276;CNV;14647262
18;;N;DEL;22499360;36935916;CNV;14436556
18;;N;DEL;36996827;42968039;CNV;5971212
18;;N;DEL;43094576;45655917;CNV;2561341
18;;N;DEL;45708779;50147673;CNV;4438894
18;;N;DEL;50147891;56514607;CNV;6366716
18;;N;DEL;56670165;59927632;CNV;3257467
18;;N;DEL;60191569;73834757;CNV;13643188
18;;N;DEL;73835753;80087573;CNV;6251820
19;;N;DUP;390341;20180454;CNV;19790113
19;;N;DEL;20315194;24189408;CNV;3874214
19;;N;DUP;27659768;31163305;CNV;3503537
19;;N;DUP;31873240;42693429;CNV;10820189
19;;N;DEL;42847012;42967413;CNV;120401
19;;N;DUP;43620583;58234565;CNV;14613982
20;;N;DEL;5311114;17376928;CNV;12065814
20;;N;DEL;19650577;22925809;CNV;3275232
20;;N;DUP;31258599;54345649;CNV;23087050
20;;N;DUP;55715737;64240906;CNV;8525169
21;;N;DUP;30815413;46680243;CNV;15864830
22;;N;DUP;15438402;21825894;CNV;6387492
22;;N;DUP;22066838;35521499;CNV;13454661
22;;N;DUP;35530340;50242600;CNV;14712260
1;;N;DEL;69144171;85985698;CNV;16841527
1;;N;DEL;86016186;107941778;CNV;21925592
1;;N;DUP;228090807;229023896;CNV;933089
1;;N;DUP;234497322;235957436;CNV;1460114
2;;N;DUP;110819;3844459;CNV;3733640
2;;N;DUP;8170944;11553522;CNV;3382578
2;;N;DEL;18208358;18589066;CNV;380708
2;;N;DUP;108322059;114508979;CNV;6186920
2;;N;DUP;158642338;160108189;CNV;1465851
2;;N;DUP;234028106;240942225;CNV;6914119
3;;N;DUP;8607776;14845289;CNV;6237513
3;;N;DUP;122776600;130231423;CNV;7454823
3;;N;DUP;183045792;187269997;CNV;4224205
5;;N;DUP;207389;3062931;CNV;2855542
5;;N;DUP;16656397;17391920;CNV;735523
5;;N;DEL;56689478;67501895;CNV;10812417
5;;N;DEL;83676102;95190696;CNV;11514594
5;;N;DEL;99100615;131948917;CNV;32848302
5;;N;DEL;161346460;166175872;CNV;4829412
6;;N;DEL;31113632;31306778;CNV;193146
6;;N;DEL;66087119;66413237;CNV;326118
6;;N;DUP;154828809;155299885;CNV;471076
7;;N;DUP;1494152;3196264;CNV;1702112
7;;N;DEL;3491643;3689925;CNV;198282
7;;N;DUP;7359773;7488288;CNV;128515
7;;N;DEL;26745261;26853269;CNV;108008
7;;N;DEL;83510763;90008294;CNV;6497531
7;;N;DUP;157529938;159059113;CNV;1529175
7;;N;DEL;159173967;159262480;CNV;88513
8;;N;DEL;3619761;5968989;CNV;2349228
8;;N;DEL;14168744;14391691;CNV;222947
8;;N;DEL;14438328;16966230;CNV;2527902
8;;N;DUP;43243912;75861613;CNV;32617701
8;;N;DUP;75889295;78929354;CNV;3040059
8;;N;DUP;79073173;82335584;CNV;3262411
8;;N;DUP;82402322;93076170;CNV;10673848
8;;N;DUP;93078993;99816910;CNV;6737917
8;;N;DUP;100193552;101866801;CNV;1673249
8;;N;DUP;101883913;122100531;CNV;20216618
8;;N;DUP;122261193;125623986;CNV;3362793
8;;N;DUP;125835843;142824280;CNV;16988437
9;;N;DUP;8332353;8926956;CNV;594603
9;;N;DEL;12019425;12084080;CNV;64655
9;;N;DEL;71377326;71380351;CNV;3025
9;;N;DUP;76072993;76471579;CNV;398586
9;;N;DEL;78900517;81056137;CNV;2155620
9;;N;DEL;101732534;104604190;CNV;2871656
10;;N;DUP;67875446;74158075;CNV;6282629
11;;N;DUP;44320977;45858559;CNV;1537582
11;;N;DUP;60626906;78650570;CNV;18023664
12;;N;DEL;9511756;9733365;CNV;221609
13;;N;DEL;37777737;38732272;CNV;954535
13;;N;DUP;94782871;96024569;CNV;1241698
13;;N;DUP;97383129;100692924;CNV;3309795
14;;N;DUP;19747289;24508761;CNV;4761472
14;;N;DUP;42142757;42718773;CNV;576016
14;;N;DEL;62532246;62616863;CNV;84617
14;;N;DUP;63320801;79045057;CNV;15724256
14;;N;DUP;88916673;106832764;CNV;17916091
15;;N;DEL;20743076;22199721;CNV;1456645
15;;N;DEL;34860448;38257841;CNV;3397393
16;;N;DEL;13656837;13656867;CNV;30
16;;N;DUP;84088601;89774300;CNV;5685699
17;;N;DEL;10458952;15168278;CNV;4709326
17;;N;DUP;75725076;82630699;CNV;6905623
18;;N;DEL;159885;5948904;CNV;5789019
18;;N;DEL;24231831;45411446;CNV;21179615
18;;N;DEL;50191925;56113342;CNV;5921417
18;;N;DEL;60391698;73665125;CNV;13273427
18;;N;DEL;75977771;76042821;CNV;65050
20;;N;DUP;167044;5862794;CNV;5695750
20;;N;DUP;17409232;18694562;CNV;1285330
20;;N;DUP;23015863;54639706;CNV;31623843
22;;N;DUP;35235551;39771138;CNV;4535587
1;;N;DEL;48017314;107178955;CNV;59161641
1;;N;DEL;117470700;117556621;CNV;85921
1;;N;DUP;118617960;183970851;CNV;65352891
1;;N;DUP;199441844;248655165;CNV;49213321
3;;N;DEL;119131;3532597;CNV;3413466
3;;N;DEL;4837700;8606810;CNV;3769110
3;;N;DEL;15180755;18579647;CNV;3398892
3;;N;DEL;18579815;21767982;CNV;3188167
3;;N;DEL;21804132;76805315;CNV;55001183
3;;N;DEL;101972970;104673952;CNV;2700982
3;;N;DEL;112132970;112203014;CNV;70044
3;;N;DUP;112208062;197336437;CNV;85128375
4;;N;DEL;10181484;125242224;CNV;115060740
4;;N;DEL;125242526;138485541;CNV;13243015
4;;N;DEL;138485703;189795030;CNV;51309327
5;;N;DUP;145599461;180644249;CNV;35044788
6;;N;DUP;14877829;16068339;CNV;1190510
7;;N;DUP;22183647;38446969;CNV;16263322
7;;N;DUP;38448074;63375308;CNV;24927234
7;;N;DUP;64036286;79003173;CNV;14966887
7;;N;DUP;104630646;108346641;CNV;3715995
7;;N;DUP;117417179;117441426;CNV;24247
7;;N;DUP;126818300;132409694;CNV;5591394
7;;N;DUP;147587709;159262480;CNV;11674771
8;;N;DUP;240568;3597214;CNV;3356646
8;;N;DUP;6095422;13290712;CNV;7195290
8;;N;DUP;69812676;70093676;CNV;281000
8;;N;DUP;141899073;142824280;CNV;925207
10;;N;DEL;49085522;64846182;CNV;15760660
10;;N;DUP;64877396;64974112;CNV;96716
10;;N;DEL;65028292;68176982;CNV;3148690
10;;N;DEL;80988029;83181848;CNV;2193819
12;;N;DEL;9511756;9694537;CNV;182781
12;;N;DUP;9733365;15525058;CNV;5791693
12;;N;DUP;24120489;26120155;CNV;1999666
12;;N;DUP;30115471;33302705;CNV;3187234
13;;N;DUP;18848939;19019278;CNV;170339
13;;N;DUP;19128546;29766893;CNV;10638347
13;;N;DUP;29774548;53178205;CNV;23403657
13;;N;DUP;53187439;68974785;CNV;15787346
13;;N;DUP;69008553;85155448;CNV;16146895
13;;N;DUP;85194828;89922244;CNV;4727416
13;;N;DUP;89923731;110653760;CNV;20730029
13;;N;DUP;110927204;114267888;CNV;3340684
14;;N;DEL;24337023;63036147;CNV;38699124
14;;N;DEL;79594346;87392862;CNV;7798516
15;;N;DUP;20743076;23694030;CNV;2950954
15;;N;DEL;23779258;30980467;CNV;7201209
15;;N;DUP;31029672;35947845;CNV;4918173
15;;N;DEL;36017564;36654713;CNV;637149
15;;N;DEL;36697959;49096052;CNV;12398093
15;;N;DEL;49100712;50107853;CNV;1007141
15;;N;DUP;50526576;52951073;CNV;2424497
15;;N;DUP;53257190;53861850;CNV;604660
15;;N;DEL;54009178;55052089;CNV;1042911
15;;N;DEL;58042147;59195731;CNV;1153584
15;;N;DUP;59204444;60712448;CNV;1508004
15;;N;DUP;60789699;61090225;CNV;300526
15;;N;DUP;61090498;61203259;CNV;112761
15;;N;DEL;61203580;66416467;CNV;5212887
15;;N;DUP;66434031;66636150;CNV;202119
15;;N;DUP;80085110;81251128;CNV;1166018
15;;N;DEL;81599216;83173728;CNV;1574512
15;;N;DUP;83483510;84826346;CNV;1342836
15;;N;DUP;87937520;90600488;CNV;2662968
15;;N;DEL;90609113;92724106;CNV;2114993
15;;N;DUP;92995200;93486387;CNV;491187
15;;N;DEL;93520066;93530802;CNV;10736
15;;N;DUP;93701242;94727614;CNV;1026372
15;;N;DEL;94728035;97019528;CNV;2291493
16;;N;DUP;20655460;48892824;CNV;28237364
16;;N;DUP;48941133;51533320;CNV;2592187
16;;N;DUP;51545446;84319977;CNV;32774531
16;;N;DUP;84429919;89774300;CNV;5344381
17;;N;DUP;27160113;82630699;CNV;55470586
18;;N;DEL;1570336;1974314;CNV;403978
18;;N;DEL;2017452;7851734;CNV;5834282
18;;N;DEL;25421750;55067395;CNV;29645645
18;;N;DEL;60683778;73591833;CNV;12908055
18;;N;DEL;76041456;76043792;CNV;2336
19;;N;DEL;42847012;42927865;CNV;80853
20;;N;DEL;6147554;15914575;CNV;9767021
20;;N;DUP;26219007;64240906;CNV;38021899
21;;N;DEL;18840127;18841604;CNV;1477
21;;N;DEL;21454493;21596979;CNV;142486
1;;N;DEL;911484;47796947;CNV;46885463
1;;N;DEL;48017314;69222963;CNV;21205649
1;;N;DEL;69228072;75694764;CNV;6466692
1;;N;DEL;75730917;79180534;CNV;3449617
1;;N;DEL;79198984;85707417;CNV;6508433
1;;N;DEL;85743698;119955463;CNV;34211765
1;;N;DUP;119970824;248655165;CNV;128684341
2;;N;DEL;34059917;34338741;CNV;278824
2;;N;DEL;41686653;41687700;CNV;1047
2;;N;DUP;45683753;45887886;CNV;204133
2;;N;DUP;46125360;49408453;CNV;3283093
2;;N;DUP;53436174;55685826;CNV;2249652
2;;N;DUP;59833445;66137512;CNV;6304067
2;;N;DUP;76990184;114508979;CNV;37518795
2;;N;DUP;116866015;116866186;CNV;171
2;;N;DUP;126356095;128735885;CNV;2379790
2;;N;DUP;226406362;240942225;CNV;14535863
3;;N;DEL;119131;1907433;CNV;1788302
3;;N;DEL;21029450;21767982;CNV;738532
3;;N;DEL;188749428;194004541;CNV;5255113
3;;N;DUP;194078012;197336437;CNV;3258425
4;;N;DUP;415163;10125354;CNV;9710191
4;;N;DUP;25299594;26347715;CNV;1048121
4;;N;DEL;26437400;37299708;CNV;10862308
4;;N;DEL;124516832;139035816;CNV;14518984
4;;N;DEL;144529807;157809375;CNV;13279568
4;;N;DEL;159720218;162342606;CNV;2622388
4;;N;DEL;163392029;167392714;CNV;4000685
4;;N;DEL;173691690;179873517;CNV;6181827
4;;N;DEL;179877852;184512851;CNV;4634999
4;;N;DEL;184636427;189795030;CNV;5158603
5;;N;DUP;90956415;91003406;CNV;46991
5;;N;DUP;150658703;151022235;CNV;363532
5;;N;DUP;170306944;175682642;CNV;5375698
6;;N;DUP;29721813;36983285;CNV;7261472
6;;N;DUP;56634391;56819921;CNV;185530
6;;N;DEL;64875518;69046218;CNV;4170700
6;;N;DEL;93445243;93493316;CNV;48073
6;;N;DEL;93493468;94286803;CNV;793335
6;;N;DUP;94313093;94446736;CNV;133643
6;;N;DEL;94455279;99663718;CNV;5208439
6;;N;DEL;99697274;104359051;CNV;4661777
6;;N;DEL;111860827;113194612;CNV;1333785
6;;N;DEL;119550431;127414216;CNV;7863785
6;;N;DEL;139667926;148034416;CNV;8366490
6;;N;DEL;150931781;154201606;CNV;3269825
6;;N;DEL;154350643;156385129;CNV;2034486
7;;N;DUP;1494152;7452544;CNV;5958392
7;;N;DUP;12770161;12953335;CNV;183174
7;;N;DUP;15059053;15059208;CNV;155
7;;N;DUP;19498787;40520137;CNV;21021350
8;;N;DEL;4650042;6095094;CNV;1445052
8;;N;DEL;13563809;16852167;CNV;3288358
8;;N;DUP;69812676;70014636;CNV;201960
8;;N;DEL;135968328;139723632;CNV;3755304
10;;N;DEL;53790610;53791314;CNV;704
10;;N;DEL;55962816;55963006;CNV;190
10;;N;DUP;64877396;65028292;CNV;150896
10;;N;DUP;67875446;80984052;CNV;13108606
10;;N;DEL;105724673;110223302;CNV;4498629
10;;N;DUP;110259930;133526341;CNV;23266411
11;;N;DUP;60389693;79374802;CNV;18985109
11;;N;DEL;90450877;90710577;CNV;259700
13;;N;DUP;18848939;53178205;CNV;34329266
13;;N;DUP;53187439;69368186;CNV;16180747
13;;N;DUP;69393716;114267888;CNV;44874172
14;;N;DEL;19747289;79572531;CNV;59825242
14;;N;DEL;79594346;88249028;CNV;8654682
14;;N;DEL;88249183;106832764;CNV;18583581
15;;N;DEL;20743076;36540540;CNV;15797464
15;;N;DUP;59165177;60066028;CNV;900851
15;;N;DUP;62989348;66416467;CNV;3427119
15;;N;DUP;66434031;67202485;CNV;768454
16;;N;DUP;215160;3176868;CNV;2961708
16;;N;DEL;5638144;5820605;CNV;182461
16;;N;DEL;5860762;6061072;CNV;200310
16;;N;DEL;6113799;6689701;CNV;575902
16;;N;DEL;6689932;7409346;CNV;719414
16;;N;DEL;12543563;15595864;CNV;3052301
16;;N;DEL;26370009;27385140;CNV;1015131
16;;N;DUP;27385274;59542582;CNV;32157308
16;;N;DUP;60844707;61597804;CNV;753097
16;;N;DUP;65806957;89774300;CNV;23967343
17;;N;DUP;601219;52208074;CNV;51606855
17;;N;DUP;54235909;82630699;CNV;28394790
18;;N;DEL;159885;80087573;CNV;79927688
19;;N;DUP;390341;58234565;CNV;57844224
20;;N;DUP;167044;5861872;CNV;5694828
20;;N;DUP;15086761;64240906;CNV;49154145
21;;N;DEL;10494342;17709650;CNV;7215308
21;;N;DEL;17709729;18839836;CNV;1130107
21;;N;DEL;18842097;30815413;CNV;11973316
21;;N;DEL;30854486;33053327;CNV;2198841
21;;N;DEL;34045080;35272975;CNV;1227895
21;;N;DEL;36563890;46680243;CNV;10116353
22;;N;DEL;15438402;50242600;CNV;34804198
3;;N;DEL;119131;1356877;CNV;1237746
3;;N;DEL;1358735;1898506;CNV;539771
3;;N;DEL;1899238;2862299;CNV;963061
3;;N;DUP;125678902;197336437;CNV;71657535
4;;N;DEL;51818725;189795030;CNV;137976305
6;;N;DEL;92566963;92567042;CNV;79
6;;N;DUP;160151834;160739051;CNV;587217
6;;N;DUP;170311386;170543473;CNV;232087
7;;N;DUP;1494152;159262480;CNV;157768328
10;;N;DEL;87839597;96128995;CNV;8289398
13;;N;DUP;18848939;45696465;CNV;26847526
13;;N;DUP;45738311;110512732;CNV;64774421
13;;N;DUP;110594030;114267888;CNV;3673858
14;;N;DEL;79594346;87899558;CNV;8305212
14;;N;DEL;87952898;102371291;CNV;14418393
14;;N;DUP;102449981;106832764;CNV;4382783
15;;N;DEL;20743076;101824457;CNV;81081381
17;;N;DEL;601219;22624646;CNV;22023427
18;;N;DUP;3327803;3328748;CNV;945
18;;N;DEL;28811224;80087573;CNV;51276349
20;;N;DEL;167044;4489235;CNV;4322191
20;;N;DEL;4506463;17810397;CNV;13303934
20;;N;DEL;17810419;19215452;CNV;1405033
20;;N;DUP;19297676;31418506;CNV;12120830
20;;N;DUP;31430739;42836502;CNV;11405763
20;;N;DUP;42836554;46832470;CNV;3995916
20;;N;DUP;46923536;51117002;CNV;4193466
20;;N;DUP;51117598;64240906;CNV;13123308
1;;N;DUP;10282917;11553106;CNV;1270189
10;;N;DEL;12891255;12892441;CNV;1186
10;;N;DEL;65674275;65688827;CNV;14552
11;;N;DUP;8783714;10002764;CNV;1219050
13;;N;DUP;18848939;65320832;CNV;46471893
13;;N;DUP;92070400;114267888;CNV;22197488
14;;N;DEL;19747289;106832764;CNV;87085475
15;;N;DEL;20743076;38652215;CNV;17909139
17;;N;DEL;601219;18074041;CNV;17472822
20;;N;DUP;32203538;43316503;CNV;11112965
20;;N;DUP;43579005;47910743;CNV;4331738
20;;N;DUP;47923392;51358442;CNV;3435050
20;;N;DUP;51835179;54877489;CNV;3042310
20;;N;DUP;54995733;56327342;CNV;1331609
20;;N;DUP;56370727;59417834;CNV;3047107
20;;N;DUP;59437602;61673638;CNV;2236036
20;;N;DUP;61684493;64240906;CNV;2556413
21;;N;DEL;10494342;46680243;CNV;36185901
3;;N;DEL;119131;2521657;CNV;2402526
3;;N;DEL;7339584;7372667;CNV;33083
7;;N;DUP;1494152;3405679;CNV;1911527
7;;N;DEL;28505714;28566658;CNV;60944
8;;N;DEL;88889108;89620537;CNV;731429
8;;N;DEL;135999084;136355249;CNV;356165
8;;N;DEL;136776958;136778556;CNV;1598
12;;N;DEL;114086628;114148512;CNV;61884
21;;N;DEL;18716841;18841604;CNV;124763
1;;N;DUP;911484;22674871;CNV;21763387
1;;N;DEL;54801836;109196558;CNV;54394722
1;;N;DUP;144009019;248655165;CNV;104646146
3;;N;DEL;119131;71541196;CNV;71422065
4;;N;DEL;10181484;52174015;CNV;41992531
7;;N;DUP;1494152;7452586;CNV;5958434
7;;N;DUP;20597809;37522765;CNV;16924956
7;;N;DUP;150479019;159262480;CNV;8783461
8;;N;DEL;240568;3811414;CNV;3570846
8;;N;DEL;8265935;21643425;CNV;13377490
9;;N;DUP;249391;1162556;CNV;913165
9;;N;DEL;29567552;29568688;CNV;1136
9;;N;DUP;35821800;137995921;CNV;102174121
10;;N;DUP;67487209;73923832;CNV;6436623
10;;N;DEL;74158075;75083097;CNV;925022
10;;N;DUP;75083167;80988029;CNV;5904862
10;;N;DEL;81003449;92042465;CNV;11039016
10;;N;DEL;104395792;109049213;CNV;4653421
11;;N;DEL;1961088;134707739;CNV;132746651
12;;N;DEL;9855249;9855298;CNV;49
12;;N;DUP;101612723;132924025;CNV;31311302
14;;N;DEL;79594346;88249183;CNV;8654837
16;;N;DEL;215160;13042802;CNV;12827642
16;;N;DEL;59843027;89774300;CNV;29931273
17;;N;DEL;601219;31582409;CNV;30981190
17;;N;DUP;31601064;34890183;CNV;3289119
17;;N;DEL;34917020;35619562;CNV;702542
17;;N;DUP;35627508;35959741;CNV;332233
17;;N;DUP;36062058;36152159;CNV;90101
17;;N;DUP;49291940;57281644;CNV;7989704
17;;N;DUP;57422703;58725332;CNV;1302629
17;;N;DUP;59360804;82630699;CNV;23269895
20;;N;DEL;167044;15629740;CNV;15462696
20;;N;DEL;15670252;15671503;CNV;1251
20;;N;DEL;15717103;26227269;CNV;10510166
20;;N;DUP;31258500;51835179;CNV;20576679
20;;N;DUP;55715737;60819859;CNV;5104122
21;;N;DUP;10494342;16543972;CNV;6049630
21;;N;DEL;18840127;18841120;CNV;993
21;;N;DUP;25547104;27766755;CNV;2219651
21;;N;DEL;27931713;31225687;CNV;3293974
4;;N;DUP;182634486;182901076;CNV;266590
5;;N;DUP;91002815;91003406;CNV;591
5;;N;DEL;126104218;126104486;CNV;268
5;;N;DEL;152413049;153790034;CNV;1376985
7;;N;DUP;1494152;3385246;CNV;1891094
7;;N;DEL;28505714;28577012;CNV;71298
7;;N;DUP;127538108;131301033;CNV;3762925
7;;N;DUP;148230187;159262480;CNV;11032293
8;;N;DEL;4430534;5540455;CNV;1109921
8;;N;DEL;5934861;6018487;CNV;83626
8;;N;DEL;136776958;136777136;CNV;178
9;;N;DUP;249391;1162447;CNV;913056
9;;N;DEL;31678561;31678990;CNV;429
9;;N;DUP;107600300;108302521;CNV;702221
9;;N;DEL;108323701;108880721;CNV;557020
9;;N;DUP;108907977;113980553;CNV;5072576
9;;N;DUP;119659757;137995921;CNV;18336164
10;;N;DEL;16809409;16809433;CNV;24
11;;N;DUP;1961088;2959601;CNV;998513
11;;N;DUP;19851300;20661604;CNV;810304
11;;N;DUP;61717684;78650570;CNV;16932886
11;;N;DUP;87279560;87522825;CNV;243265
11;;N;DEL;99902439;99949661;CNV;47222
12;;N;DUP;24789733;25883047;CNV;1093314
12;;N;DEL;82961773;87801317;CNV;4839544
13;;N;DEL;37862511;38226128;CNV;363617
14;;N;DEL;45904359;48848141;CNV;2943782
14;;N;DUP;72825470;78338968;CNV;5513498
14;;N;DEL;79611895;79626911;CNV;15016
15;;N;DEL;35394066;36780098;CNV;1386032
15;;N;DEL;45844625;46218683;CNV;374058
15;;N;DEL;46218731;46219715;CNV;984
15;;N;DEL;46405948;46948720;CNV;542772
15;;N;DEL;48604633;48608389;CNV;3756
16;;N;DUP;84142165;89774300;CNV;5632135
17;;N;DEL;601219;27409092;CNV;26807873
17;;N;DEL;32709747;33241134;CNV;531387
17;;N;DUP;33330590;34499555;CNV;1168965
17;;N;DEL;34506143;35690325;CNV;1184182
17;;N;DUP;35713767;36111746;CNV;397979
17;;N;DEL;36111966;44030983;CNV;7919017
17;;N;DUP;44770726;46042270;CNV;1271544
17;;N;DEL;46057993;49661184;CNV;3603191
17;;N;DUP;50196930;51417448;CNV;1220518
17;;N;DEL;51510889;51713815;CNV;202926
17;;N;DEL;51735178;52589203;CNV;854025
17;;N;DEL;52643711;53107531;CNV;463820
17;;N;DUP;53120224;53501617;CNV;381393
17;;N;DEL;55763472;56868833;CNV;1105361
17;;N;DUP;57051187;58725332;CNV;1674145
17;;N;DEL;59360804;61726949;CNV;2366145
17;;N;DUP;61798564;62335640;CNV;537076
17;;N;DEL;62723827;66933497;CNV;4209670
17;;N;DUP;67085903;67558578;CNV;472675
17;;N;DEL;67885843;70313179;CNV;2427336
17;;N;DUP;70330197;70643558;CNV;313361
17;;N;DEL;70709882;71515958;CNV;806076
17;;N;DUP;71664926;72466705;CNV;801779
17;;N;DEL;72588188;73763821;CNV;1175633
17;;N;DUP;73982830;82630699;CNV;8647869
20;;N;DEL;167044;5861872;CNV;5694828
20;;N;DEL;5862794;17559507;CNV;11696713
20;;N;DEL;17562692;31258500;CNV;13695808
20;;N;DUP;31258599;35017295;CNV;3758696
20;;N;DUP;35065161;43579005;CNV;8513844
20;;N;DUP;43584147;54639706;CNV;11055559
20;;N;DUP;55675547;64240906;CNV;8565359
21;;N;DEL;10494342;18839836;CNV;8345494
21;;N;DEL;30854486;46680243;CNV;15825757
1;;N;DUP;119955463;231382108;CNV;111426645
1;;N;DEL;231401381;231408034;CNV;6653
1;;N;DUP;231425284;248655165;CNV;17229881
4;;N;DEL;53807096;189795030;CNV;135987934
5;;N;DUP;6020305;10909404;CNV;4889099
6;;N;DEL;107770146;109227510;CNV;1457364
8;;N;DUP;240568;241226;CNV;658
8;;N;DEL;4650042;5035549;CNV;385507
13;;N;DEL;101580850;101621487;CNV;40637
14;;N;DEL;19747289;19952179;CNV;204890
14;;N;DUP;23755318;23755792;CNV;474
14;;N;DUP;78128312;78128422;CNV;110
15;;N;DEL;22869663;39366242;CNV;16496579
15;;N;DEL;45880004;46824834;CNV;944830
15;;N;DEL;53368284;57769803;CNV;4401519
15;;N;DEL;57793560;57799107;CNV;5547
15;;N;DEL;86710303;86752460;CNV;42157
16;;N;DEL;5638144;7019055;CNV;1380911
16;;N;DUP;15771332;19336599;CNV;3565267
16;;N;DUP;51171908;51528619;CNV;356711
17;;N;DUP;22624646;31775266;CNV;9150620
17;;N;DEL;33831897;33833716;CNV;1819
17;;N;DUP;57696445;58113647;CNV;417202
17;;N;DUP;58237342;74703694;CNV;16466352
21;;N;DEL;24027644;24028385;CNV;741
21;;N;DUP;30185631;46680243;CNV;16494612
1;;N;DEL;911484;65579645;CNV;64668161
1;;N;DEL;65580244;85905466;CNV;20325222
1;;N;DEL;85911345;148788368;CNV;62877023
2;;N;DEL;122597664;139279446;CNV;16681782
2;;N;DEL;160125285;173739201;CNV;13613916
4;;N;DUP;415163;37796219;CNV;37381056
4;;N;DEL;178191843;189795030;CNV;11603187
5;;N;DEL;112832244;132201060;CNV;19368816
6;;N;DEL;205610;47895910;CNV;47690300
6;;N;DEL;47896376;92525020;CNV;44628644
6;;N;DEL;92639124;117878274;CNV;25239150
6;;N;DEL;155646901;161672108;CNV;6025207
6;;N;DEL;161860501;165652172;CNV;3791671
6;;N;DEL;165755520;170543473;CNV;4787953
7;;N;DUP;1494152;22816987;CNV;21322835
9;;N;DUP;249391;5883409;CNV;5634018
9;;N;DUP;119661931;137995921;CNV;18333990
11;;N;DEL;1961088;7167772;CNV;5206684
12;;N;DUP;114256;19794974;CNV;19680718
12;;N;DEL;124638065;132924025;CNV;8285960
13;;N;DUP;18848939;114267888;CNV;95418949
16;;N;DEL;6314278;6349836;CNV;35558
17;;N;DEL;601219;82630699;CNV;82029480
19;;N;DUP;390341;19612406;CNV;19222065
20;;N;DUP;167044;64240906;CNV;64073862
5;;N;DEL;110200882;112904462;CNV;2703580
8;;N;DEL;3790798;5968989;CNV;2178191
9;;N;DEL;8177428;8189112;CNV;11684
9;;N;DEL;11990405;12043425;CNV;53020
9;;N;DEL;104603689;104604190;CNV;501
12;;N;DEL;114040306;114172337;CNV;132031
13;;N;DUP;24615072;25045683;CNV;430611
16;;N;DUP;57253106;57971480;CNV;718374
20;;N;DUP;167044;6147554;CNV;5980510
20;;N;DEL;8482484;8488675;CNV;6191
1;;N;DEL;911484;3035270;CNV;2123786
8;;N;DEL;14721200;14721296;CNV;96
8;;N;DEL;77639021;77639128;CNV;107
20;;N;DUP;15670252;15670388;CNV;136
3;;N;DEL;60014946;60644106;CNV;629160
4;;N;DUP;59449187;59837296;CNV;388109
5;;N;DEL;79785890;79786524;CNV;634
7;;N;DUP;1494152;54649836;CNV;53155684
7;;N;DUP;69679206;93501350;CNV;23822144
7;;N;DEL;93501505;93510175;CNV;8670
7;;N;DUP;93524748;159262480;CNV;65737732
8;;N;DEL;2196998;2215736;CNV;18738
12;;N;DUP;114256;16103435;CNV;15989179
12;;N;DEL;16159452;16170605;CNV;11153
12;;N;DUP;16182436;82035813;CNV;65853377
12;;N;DEL;82035957;82036357;CNV;400
12;;N;DUP;82036504;132924025;CNV;50887521
14;;N;DEL;72268639;72269330;CNV;691
16;;N;DEL;6264861;6869983;CNV;605122
17;;N;DEL;601219;17074496;CNV;16473277
19;;N;DUP;27659768;58234565;CNV;30574797
20;;N;DUP;167044;14802096;CNV;14635052
20;;N;DEL;14868013;15112218;CNV;244205
20;;N;DUP;15131646;64240906;CNV;49109260
3;;N;DEL;74046333;74223524;CNV;177191
7;;N;DUP;112437393;112457066;CNV;19673
9;;N;DEL;8159670;8189112;CNV;29442
9;;N;DEL;11990405;12144878;CNV;154473
9;;N;DUP;24354124;25902765;CNV;1548641
10;;N;DEL;62907455;62908288;CNV;833
15;;N;DEL;46095538;46490337;CNV;394799
15;;N;DUP;57862575;58015183;CNV;152608
2;;N;DEL;67555802;67556016;CNV;214
5;;N;DEL;13214740;13214762;CNV;22
17;;N;DUP;71670362;71670412;CNV;50
2;;N;DUP;81612041;81613464;CNV;1423
2;;N;DEL;184146130;184146236;CNV;106
3;;N;DEL;60432629;60530045;CNV;97416
4;;N;DEL;15990863;15991208;CNV;345
4;;N;DUP;88997478;89766356;CNV;768878
6;;N;DEL;120062712;120062996;CNV;284
8;;N;DEL;4715320;5963363;CNV;1248043
12;;N;DEL;20861205;20861229;CNV;24
16;;N;DEL;78504458;78780557;CNV;276099
16;;N;DEL;78867714;79057261;CNV;189547
17;;N;DEL;4074974;7071647;CNV;2996673
1;;N;DUP;200780032;207641844;CNV;6861812
3;;N;DUP;12305239;13459754;CNV;1154515
3;;N;DUP;44249974;52483190;CNV;8233216
6;;N;DUP;134365722;134417047;CNV;51325
8;;N;DEL;240568;3597059;CNV;3356491
8;;N;DEL;3597214;4630524;CNV;1033310
8;;N;DEL;4715320;5968785;CNV;1253465
8;;N;DEL;5968989;39977300;CNV;34008311
8;;N;DUP;40098190;42074448;CNV;1976258
8;;N;DUP;43243912;50715557;CNV;7471645
8;;N;DEL;50832248;71357915;CNV;20525667
8;;N;DUP;71558166;142824280;CNV;71266114
9;;N;DUP;108907977;114045568;CNV;5137591
10;;N;DUP;78586629;78716768;CNV;130139
10;;N;DUP;78728444;79199760;CNV;471316
11;;N;DEL;56949307;61717684;CNV;4768377
11;;N;DUP;64435257;71254030;CNV;6818773
11;;N;DEL;71307043;76045630;CNV;4738587
11;;N;DUP;76245304;76786388;CNV;541084
11;;N;DEL;76787325;131824982;CNV;55037657
11;;N;DEL;131872706;134707739;CNV;2835033
13;;N;DEL;101883006;101883280;CNV;274
13;;N;DUP;109412253;110333260;CNV;921007
14;;N;DUP;98249239;106832764;CNV;8583525
17;;N;DEL;601219;13195132;CNV;12593913
17;;N;DEL;13225826;15234289;CNV;2008463
17;;N;DEL;15264658;22624646;CNV;7359988
17;;N;DUP;27085689;51417448;CNV;24331759
17;;N;DUP;51510889;54447260;CNV;2936371
17;;N;DUP;54473516;82630699;CNV;28157183
19;;N;DEL;54050443;54600262;CNV;549819
20;;N;DEL;8482484;8489234;CNV;6750
20;;N;DEL;14802096;15086761;CNV;284665
20;;N;DUP;16034281;20053851;CNV;4019570
1;;N;DEL;911484;30838571;CNV;29927087
4;;N;DEL;90669115;91409204;CNV;740089
6;;N;DEL;72926512;123326272;CNV;50399760
6;;N;DUP;123361613;123361883;CNV;270
6;;N;DEL;123405186;128254409;CNV;4849223
6;;N;DUP;128507123;143023010;CNV;14515887
6;;N;DUP;143063099;143063724;CNV;625
8;;N;DUP;240568;3750620;CNV;3510052
8;;N;DUP;4632030;4644964;CNV;12934
8;;N;DUP;5964877;7046673;CNV;1081796
8;;N;DEL;8265935;26717336;CNV;18451401
9;;N;DEL;26176532;26177047;CNV;515
9;;N;DEL;114516564;120884210;CNV;6367646
10;;N;DEL;223755;3854037;CNV;3630282
16;;N;DUP;20816988;51467515;CNV;30650527
17;;N;DUP;601219;2489073;CNV;1887854
17;;N;DEL;3193014;29048821;CNV;25855807
17;;N;DUP;29136998;82630699;CNV;53493701
19;;N;DEL;45824451;46041053;CNV;216602
21;;N;DEL;18716841;18909856;CNV;193015
1;;N;DEL;208591490;209300349;CNV;708859
1;;N;DEL;231382019;233523544;CNV;2141525
3;;N;DEL;119131;12112265;CNV;11993134
3;;N;DEL;175157784;175622372;CNV;464588
5;;N;DEL;123883026;126836503;CNV;2953477
7;;N;DUP;1494152;2770844;CNV;1276692
7;;N;DUP;2780569;64284881;CNV;61504312
7;;N;DEL;64306688;66956156;CNV;2649468
7;;N;DEL;150066677;159262480;CNV;9195803
8;;N;DEL;240568;3808463;CNV;3567895
8;;N;DEL;3808576;5963363;CNV;2154787
8;;N;DEL;5964877;40869925;CNV;34905048
8;;N;DUP;41009056;136755501;CNV;95746445
8;;N;DUP;136778556;142824280;CNV;6045724
10;;N;DEL;43097595;51173498;CNV;8075903
10;;N;DEL;51232731;66490895;CNV;15258164
10;;N;DEL;66492193;133526341;CNV;67034148
11;;N;DEL;115545673;122496936;CNV;6951263
12;;N;DUP;114256;114490;CNV;234
12;;N;DEL;166853;23897683;CNV;23730830
12;;N;DEL;23916186;24249322;CNV;333136
12;;N;DEL;24264619;26459137;CNV;2194518
12;;N;DEL;26485024;30051974;CNV;3566950
12;;N;DEL;30053308;38016885;CNV;7963577
14;;N;DEL;44038400;44038982;CNV;582
16;;N;DEL;78424853;78601329;CNV;176476
16;;N;DEL;82360672;82670240;CNV;309568
17;;N;DEL;601219;27160113;CNV;26558894
18;;N;DEL;2990802;13188837;CNV;10198035
18;;N;DEL;22247510;80087573;CNV;57840063
21;;N;DEL;18296660;18341504;CNV;44844
21;;N;DEL;21454493;21455587;CNV;1094
1;;N;DEL;187566146;193122854;CNV;5556708
3;;N;DEL;78851426;80958514;CNV;2107088
3;;N;DEL;103283346;104673952;CNV;1390606
4;;N;DUP;415163;10103046;CNV;9687883
4;;N;DEL;124057507;137841472;CNV;13783965
4;;N;DEL;160184101;160184448;CNV;347
5;;N;DEL;18713443;31357067;CNV;12643624
6;;N;DEL;22117206;23580474;CNV;1463268
6;;N;DUP;40356190;40356555;CNV;365
6;;N;DUP;47108063;47153539;CNV;45476
6;;N;DUP;47179826;47755941;CNV;576115
7;;N;DEL;82666113;87416268;CNV;4750155
7;;N;DEL;118251118;126582822;CNV;8331704
8;;N;DEL;3620814;5968989;CNV;2348175
8;;N;DEL;114014973;115985686;CNV;1970713
8;;N;DEL;136018820;139723632;CNV;3704812
9;;N;DEL;101731484;104921355;CNV;3189871
10;;N;DEL;80787964;83181848;CNV;2393884
11;;N;DUP;1961088;2977640;CNV;1016552
11;;N;DUP;19908889;20661604;CNV;752715
11;;N;DEL;88674294;91863979;CNV;3189685
11;;N;DEL;121249421;122238001;CNV;988580
12;;N;DUP;114256;8689238;CNV;8574982
12;;N;DUP;8942630;9511756;CNV;569126
12;;N;DUP;9694537;9770255;CNV;75718
12;;N;DUP;10023545;16483409;CNV;6459864
12;;N;DUP;16497734;97215324;CNV;80717590
12;;N;DUP;97291279;132924025;CNV;35632746
13;;N;DEL;53217760;70875144;CNV;17657384
13;;N;DEL;78410395;78413821;CNV;3426
13;;N;DEL;85698523;89821719;CNV;4123196
14;;N;DEL;25147330;30021156;CNV;4873826
14;;N;DEL;32704178;33241581;CNV;537403
14;;N;DEL;62484238;62917116;CNV;432878
14;;N;DUP;72372882;79045057;CNV;6672175
14;;N;DEL;79046830;87952898;CNV;8906068
21;;N;DEL;18697646;18841604;CNV;143958
4;;N;DEL;10125607;39121077;CNV;28995470
4;;N;DUP;39159614;39828229;CNV;668615
4;;N;DEL;40145137;125694828;CNV;85549691
4;;N;DEL;125890494;126520137;CNV;629643
4;;N;DEL;126526985;137017182;CNV;10490197
4;;N;DEL;137017211;137338570;CNV;321359
4;;N;DEL;137347410;181437504;CNV;44090094
6;;N;DUP;205610;47895910;CNV;47690300
6;;N;DUP;51866975;53399687;CNV;1532712
6;;N;DEL;66412192;66413451;CNV;1259
6;;N;DUP;66417061;75190564;CNV;8773503
6;;N;DEL;75191009;75192666;CNV;1657
6;;N;DUP;75250393;88512074;CNV;13261681
6;;N;DUP;105525589;123326272;CNV;17800683
6;;N;DUP;124364036;149798900;CNV;25434864
6;;N;DUP;149840425;150696458;CNV;856033
6;;N;DUP;150703144;170543473;CNV;19840329
7;;N;DUP;22716381;38446969;CNV;15730588
7;;N;DUP;38448074;144659103;CNV;106211029
7;;N;DEL;144774457;144775539;CNV;1082
8;;N;DEL;240568;46370071;CNV;46129503
8;;N;DUP;46646865;119415408;CNV;72768543
8;;N;DUP;119423572;135894544;CNV;16470972
8;;N;DUP;135894901;142824280;CNV;6929379
9;;N;DEL;12019425;12024416;CNV;4991
9;;N;DEL;13701928;13715576;CNV;13648
10;;N;DEL;80625285;83702351;CNV;3077066
11;;N;DUP;20564257;20661604;CNV;97347
11;;N;DUP;86404975;86638537;CNV;233562
13;;N;DEL;18848939;19010337;CNV;161398
13;;N;DUP;19016196;30462228;CNV;11446032
13;;N;DEL;61157234;69448866;CNV;8291632
15;;N;DEL;34797231;39039593;CNV;4242362
16;;N;DUP;78177869;79202697;CNV;1024828
16;;N;DUP;83803678;89774300;CNV;5970622
17;;N;DUP;61167913;82630699;CNV;21462786
18;;N;DEL;25201886;64330524;CNV;39128638
18;;N;DEL;64342353;64999005;CNV;656652
18;;N;DEL;65249496;80087573;CNV;14838077
20;;N;DUP;167044;7756893;CNV;7589849
20;;N;DUP;8646662;54388448;CNV;45741786
20;;N;DUP;55670853;64240906;CNV;8570053
1;;N;DEL;87707277;87707713;CNV;436
8;;N;DUP;3959669;6023894;CNV;2064225
1;;N;DEL;911484;18476528;CNV;17565044
1;;N;DEL;107935631;116801933;CNV;8866302
1;;N;DEL;179547581;185546329;CNV;5998748
2;;N;DUP;10986627;67531531;CNV;56544904
2;;N;DEL;70835517;161061062;CNV;90225545
3;;N;DEL;63008961;63067421;CNV;58460
3;;N;DUP;104566972;104712743;CNV;145771
4;;N;DEL;26437400;26438009;CNV;609
4;;N;DUP;39056717;105503432;CNV;66446715
4;;N;DUP;133246811;133247883;CNV;1072
4;;N;DEL;134368833;189795030;CNV;55426197
5;;N;DUP;8439813;32395396;CNV;23955583
5;;N;DEL;32491624;32947811;CNV;456187
5;;N;DUP;33056239;44480915;CNV;11424676
5;;N;DEL;45249502;59838699;CNV;14589197
5;;N;DUP;59855302;59856683;CNV;1381
5;;N;DEL;59966159;83262773;CNV;23296614
5;;N;DEL;103375958;146443578;CNV;43067620
5;;N;DEL;146544721;146545372;CNV;651
5;;N;DEL;146585334;156447321;CNV;9861987
5;;N;DEL;166296690;180644249;CNV;14347559
6;;N;DUP;33092992;33094153;CNV;1161
6;;N;DUP;54705226;54759849;CNV;54623
6;;N;DUP;76898439;78250349;CNV;1351910
6;;N;DEL;82828878;100677416;CNV;17848538
6;;N;DEL;103451398;115467637;CNV;12016239
6;;N;DUP;119921558;120075094;CNV;153536
6;;N;DUP;153022817;157347549;CNV;4324732
6;;N;DEL;157549636;167784074;CNV;10234438
8;;N;DEL;240568;14168744;CNV;13928176
8;;N;DEL;14208078;19990179;CNV;5782101
8;;N;DEL;20059808;30353003;CNV;10293195
8;;N;DUP;30417621;30524355;CNV;106734
8;;N;DUP;35838032;36651697;CNV;813665
8;;N;DUP;36810768;37496263;CNV;685495
8;;N;DUP;38806656;125835843;CNV;87029187
8;;N;DUP;125849603;128793434;CNV;2943831
8;;N;DUP;128793666;133282109;CNV;4488443
9;;N;DEL;249391;4483189;CNV;4233798
9;;N;DUP;4506655;6906384;CNV;2399729
9;;N;DUP;6977233;7895438;CNV;918205
9;;N;DUP;7915577;12024416;CNV;4108839
9;;N;DEL;12028131;32614525;CNV;20586394
9;;N;DUP;32748534;34581527;CNV;1832993
9;;N;DUP;102115853;102231390;CNV;115537
10;;N;DUP;19625967;19852907;CNV;226940
10;;N;DEL;66978159;80912470;CNV;13934311
11;;N;DUP;22459887;25100812;CNV;2640925
11;;N;DUP;84177196;85035613;CNV;858417
11;;N;DUP;85074947;85076510;CNV;1563
11;;N;DUP;85094257;86118825;CNV;1024568
11;;N;DEL;107047526;134707739;CNV;27660213
12;;N;DUP;5101335;51787414;CNV;46686079
12;;N;DEL;51787900;54732702;CNV;2944802
12;;N;DEL;68811507;70653955;CNV;1842448
12;;N;DEL;95828790;132924025;CNV;37095235
13;;N;DUP;18848939;33048558;CNV;14199619
13;;N;DEL;33050038;33050752;CNV;714
13;;N;DUP;33080871;53669754;CNV;20588883
13;;N;DUP;53779427;89251855;CNV;35472428
13;;N;DUP;89256027;114267888;CNV;25011861
14;;N;DUP;23755318;55142516;CNV;31387198
15;;N;DEL;20743076;34861661;CNV;14118585
15;;N;DUP;34863204;35414041;CNV;550837
15;;N;DUP;35455170;36089640;CNV;634470
16;;N;DEL;215160;6695598;CNV;6480438
16;;N;DUP;19218340;19282086;CNV;63746
16;;N;DEL;35401804;85213589;CNV;49811785
16;;N;DEL;85786596;89774300;CNV;3987704
18;;N;DUP;2698127;2935024;CNV;236897
18;;N;DEL;2946293;3320160;CNV;373867
18;;N;DEL;3347815;13810829;CNV;10463014
18;;N;DUP;32841782;41922439;CNV;9080657
18;;N;DUP;41974975;45517785;CNV;3542810
18;;N;DEL;45654835;48444360;CNV;2789525
18;;N;DUP;48458820;49352492;CNV;893672
18;;N;DEL;49653531;50129023;CNV;475492
18;;N;DEL;50147673;75153209;CNV;25005536
18;;N;DEL;75162349;75706428;CNV;544079
18;;N;DEL;75762781;80087573;CNV;4324792
21;;N;DEL;10494342;35679693;CNV;25185351
21;;N;DEL;35755779;46680243;CNV;10924464
1;;N;DEL;911484;69144171;CNV;68232687
1;;N;DEL;69193736;73519185;CNV;4325449
1;;N;DEL;207251041;207251382;CNV;341
2;;N;DUP;110819;239597;CNV;128778
2;;N;DUP;155808598;161525626;CNV;5717028
2;;N;DUP;161605699;226738639;CNV;65132940
2;;N;DUP;226913729;228022957;CNV;1109228
2;;N;DUP;228057877;240942225;CNV;12884348
3;;N;DEL;1356877;1907433;CNV;550556
3;;N;DEL;2682331;2862299;CNV;179968
3;;N;DUP;8736020;14260348;CNV;5524328
3;;N;DUP;30435144;34435678;CNV;4000534
3;;N;DEL;34486317;36101858;CNV;1615541
3;;N;DUP;36106838;36198180;CNV;91342
3;;N;DEL;36207989;36408887;CNV;200898
3;;N;DEL;60629857;60644106;CNV;14249
3;;N;DUP;121899209;130352461;CNV;8453252
4;;N;DEL;129846060;137338570;CNV;7492510
4;;N;DEL;184512851;189795030;CNV;5282179
5;;N;DEL;17255255;31317422;CNV;14062167
5;;N;DEL;99116670;99913762;CNV;797092
5;;N;DEL;100570330;107589128;CNV;7018798
5;;N;DEL;107613373;108668733;CNV;1055360
5;;N;DEL;108696765;124016206;CNV;15319441
5;;N;DUP;124150913;124189149;CNV;38236
5;;N;DEL;124209397;133473455;CNV;9264058
6;;N;DEL;143220843;143433120;CNV;212277
6;;N;DUP;143468549;144994102;CNV;1525553
6;;N;DUP;148048348;150703144;CNV;2654796
6;;N;DEL;161596142;170543473;CNV;8947331
7;;N;DUP;3436912;7521202;CNV;4084290
7;;N;DUP;7532584;7977268;CNV;444684
7;;N;DUP;7982095;19498322;CNV;11516227
7;;N;DUP;19498476;28505257;CNV;9006781
7;;N;DUP;28577012;40520137;CNV;11943125
7;;N;DUP;40618681;42485084;CNV;1866403
7;;N;DUP;42485836;48504615;CNV;6018779
7;;N;DUP;48505653;62969063;CNV;14463410
7;;N;DUP;63073187;66485627;CNV;3412440
7;;N;DUP;70501206;78610431;CNV;8109225
7;;N;DEL;81494193;81578585;CNV;84392
7;;N;DUP;148767583;159262480;CNV;10494897
8;;N;DEL;3790798;5960606;CNV;2169808
8;;N;DUP;30353003;30417826;CNV;64823
8;;N;DUP;66312480;69298585;CNV;2986105
8;;N;DUP;69392872;69533001;CNV;140129
8;;N;DUP;69543712;69694927;CNV;151215
8;;N;DUP;70034358;82489173;CNV;12454815
8;;N;DUP;83822486;93079537;CNV;9257051
8;;N;DUP;93139859;103253277;CNV;10113418
8;;N;DUP;103256742;109451629;CNV;6194887
8;;N;DUP;109463347;109479735;CNV;16388
8;;N;DUP;109509287;119802542;CNV;10293255
8;;N;DUP;119839860;135894544;CNV;16054684
8;;N;DUP;135894901;139296354;CNV;3401453
10;;N;DUP;92518109;93410356;CNV;892247
11;;N;DEL;121764353;121818901;CNV;54548
12;;N;DEL;9511756;9733403;CNV;221647
13;;N;DEL;31139385;31333604;CNV;194219
13;;N;DEL;60704346;67174710;CNV;6470364
13;;N;DEL;85768314;86416841;CNV;648527
13;;N;DEL;86640314;88100102;CNV;1459788
14;;N;DEL;19747289;24864369;CNV;5117080
14;;N;DEL;24891169;30021156;CNV;5129987
14;;N;DEL;30026513;38141507;CNV;8114994
14;;N;DEL;38233156;52331083;CNV;14097927
14;;N;DEL;52343219;57464726;CNV;5121507
14;;N;DUP;57465202;57538137;CNV;72935
14;;N;DEL;57548930;62494231;CNV;4945301
14;;N;DEL;62531384;63036147;CNV;504763
14;;N;DEL;63099917;72521938;CNV;9422021
14;;N;DEL;78976953;88229304;CNV;9252351
14;;N;DEL;88229366;106832764;CNV;18603398
15;;N;DEL;45844625;46948720;CNV;1104095
16;;N;DUP;78187821;78304867;CNV;117046
17;;N;DEL;601219;27132035;CNV;26530816
18;;N;DEL;159885;23390742;CNV;23230857
18;;N;DEL;23547946;28411232;CNV;4863286
18;;N;DEL;28433424;54977181;CNV;26543757
18;;N;DEL;55045900;59927632;CNV;4881732
18;;N;DEL;60191569;70808381;CNV;10616812
18;;N;DEL;70949152;71380915;CNV;431763
18;;N;DEL;71392111;75762781;CNV;4370670
18;;N;DEL;75968143;76043613;CNV;75470
18;;N;DEL;76043792;80087573;CNV;4043781
21;;N;DEL;10494342;15568986;CNV;5074644
21;;N;DEL;15585207;16520120;CNV;934913
21;;N;DEL;16531594;16662832;CNV;131238
21;;N;DEL;16671032;16847699;CNV;176667
21;;N;DEL;16855919;18093720;CNV;1237801
21;;N;DEL;18132538;18694386;CNV;561848
21;;N;DEL;18697053;18839836;CNV;142783
21;;N;DEL;18842097;20756781;CNV;1914684
21;;N;DEL;20818971;21463626;CNV;644655
21;;N;DEL;21515449;22844078;CNV;1328629
21;;N;DEL;22871006;24965625;CNV;2094619
21;;N;DEL;24966635;26121209;CNV;1154574
21;;N;DEL;26121885;28421609;CNV;2299724
21;;N;DEL;28627648;29162766;CNV;535118
21;;N;DEL;29177040;29891291;CNV;714251
21;;N;DEL;30104691;30787962;CNV;683271
21;;N;DUP;30989698;34182383;CNV;3192685
21;;N;DEL;34259546;36557014;CNV;2297468
21;;N;DEL;36563890;36564357;CNV;467
21;;N;DEL;37678765;37912532;CNV;233767
21;;N;DEL;37992329;39959328;CNV;1966999
21;;N;DEL;40010284;40948953;CNV;938669
21;;N;DEL;40965879;42169820;CNV;1203941
1;;N;DEL;68246675;75694764;CNV;7448089
1;;N;DEL;77404639;82772643;CNV;5368004
1;;N;DEL;95168166;102407112;CNV;7238946
1;;N;DUP;107022459;187171686;CNV;80149227
1;;N;DUP;199441844;200780032;CNV;1338188
1;;N;DUP;200818949;207641844;CNV;6822895
1;;N;DUP;207701830;208801804;CNV;1099974
1;;N;DEL;208879207;208941027;CNV;61820
1;;N;DUP;208953571;215300671;CNV;6347100
1;;N;DUP;219172645;227818357;CNV;8645712
1;;N;DUP;227962115;230169566;CNV;2207451
1;;N;DUP;230173735;234445657;CNV;4271922
1;;N;DUP;234447872;235957436;CNV;1509564
2;;N;DUP;8297119;11524223;CNV;3227104
2;;N;DEL;57048839;57841491;CNV;792652
2;;N;DEL;59428391;59833445;CNV;405054
2;;N;DUP;64129511;65263525;CNV;1134014
2;;N;DUP;70369159;70493874;CNV;124715
2;;N;DEL;114508979;126337159;CNV;11828180
2;;N;DEL;129256416;140100613;CNV;10844197
2;;N;DEL;140109687;147428304;CNV;7318617
2;;N;DEL;147466175;158598277;CNV;11132102
2;;N;DEL;161605699;167785420;CNV;6179721
2;;N;DEL;179651817;188985047;CNV;9333230
2;;N;DEL;193055710;196627552;CNV;3571842
2;;N;DEL;208918443;215568289;CNV;6649846
3;;N;DEL;119131;8415693;CNV;8296562
3;;N;DEL;16058649;21001999;CNV;4943350
3;;N;DEL;21029450;21914292;CNV;884842
3;;N;DEL;21914412;31371984;CNV;9457572
3;;N;DUP;31382501;34504065;CNV;3121564
3;;N;DUP;36106838;50586323;CNV;14479485
3;;N;DEL;50819337;83324449;CNV;32505112
3;;N;DEL;83365559;86063084;CNV;2697525
3;;N;DEL;86253662;87279598;CNV;1025936
3;;N;DEL;87297965;89913897;CNV;2615932
4;;N;DEL;10181484;28918498;CNV;18737014
4;;N;DEL;28934741;33685038;CNV;4750297
4;;N;DEL;33723783;37560661;CNV;3836878
4;;N;DEL;41008551;46923796;CNV;5915245
4;;N;DEL;77985527;81591303;CNV;3605776
4;;N;DUP;81695667;82248580;CNV;552913
4;;N;DEL;83712560;91365454;CNV;7652894
4;;N;DEL;91395333;92588008;CNV;1192675
4;;N;DEL;92725350;125694828;CNV;32969478
4;;N;DEL;126526985;128322750;CNV;1795765
4;;N;DUP;128551184;128605410;CNV;54226
4;;N;DEL;128605841;129991405;CNV;1385564
4;;N;DEL;130008305;137239398;CNV;7231093
4;;N;DEL;137315158;155816233;CNV;18501075
4;;N;DEL;155866062;163832369;CNV;7966307
4;;N;DEL;163848106;166095377;CNV;2247271
4;;N;DEL;166101207;189795030;CNV;23693823
5;;N;DUP;207389;19545212;CNV;19337823
5;;N;DUP;29873567;42807322;CNV;12933755
5;;N;DUP;42838454;43368188;CNV;529734
5;;N;DEL;83689920;132173578;CNV;48483658
5;;N;DEL;143601201;148572976;CNV;4971775
5;;N;DEL;151905042;153316547;CNV;1411505
5;;N;DEL;153339276;153358015;CNV;18739
5;;N;DEL;153410061;153790034;CNV;379973
5;;N;DEL;161346460;167829666;CNV;6483206
6;;N;DUP;51957499;53036234;CNV;1078735
6;;N;DUP;56351132;57126875;CNV;775743
6;;N;DEL;66202173;66419338;CNV;217165
6;;N;DEL;91620884;93493468;CNV;1872584
6;;N;DUP;124546384;133811378;CNV;9264994
6;;N;DUP;133871632;134892348;CNV;1020716
6;;N;DUP;134925156;139910343;CNV;4985187
6;;N;DUP;142780526;144994102;CNV;2213576
6;;N;DUP;147075609;147284871;CNV;209262
6;;N;DUP;147919646;149766383;CNV;1846737
6;;N;DUP;149798900;151002778;CNV;1203878
6;;N;DUP;151251167;157685115;CNV;6433948
6;;N;DUP;157686481;160795576;CNV;3109095
6;;N;DUP;160811739;163007978;CNV;2196239
6;;N;DUP;165375817;170543473;CNV;5167656
7;;N;DUP;1494152;8382034;CNV;6887882
7;;N;DUP;8454756;10758865;CNV;2304109
7;;N;DUP;10783801;12044849;CNV;1261048
7;;N;DUP;12088973;18082973;CNV;5994000
7;;N;DUP;18114883;21780920;CNV;3666037
7;;N;DEL;21812962;21813483;CNV;521
7;;N;DUP;21815550;28505257;CNV;6689707
7;;N;DUP;28577012;33953371;CNV;5376359
7;;N;DUP;34103506;67058437;CNV;32954931
7;;N;DUP;71124893;77404620;CNV;6279727
7;;N;DEL;78286915;96981535;CNV;18694620
7;;N;DUP;97020044;106367111;CNV;9347067
7;;N;DUP;157588979;159262480;CNV;1673501
8;;N;DEL;240568;1120240;CNV;879672
8;;N;DEL;1193650;3722560;CNV;2528910
8;;N;DEL;3750620;5968989;CNV;2218369
8;;N;DEL;6017973;14208078;CNV;8190105
8;;N;DEL;14208244;16851103;CNV;2642859
8;;N;DEL;16852167;27050420;CNV;10198253
8;;N;DEL;27073668;27751217;CNV;677549
8;;N;DEL;27751238;30185142;CNV;2433904
8;;N;DEL;30198880;37023284;CNV;6824404
8;;N;DUP;37069431;48861025;CNV;11791594
8;;N;DEL;54808736;55395087;CNV;586351
8;;N;DUP;66312480;69694927;CNV;3382447
8;;N;DUP;70034358;75125493;CNV;5091135
8;;N;DUP;75127087;79585637;CNV;4458550
8;;N;DUP;79699954;82335584;CNV;2635630
8;;N;DUP;82402322;86029498;CNV;3627176
8;;N;DUP;86059563;87791196;CNV;1731633
8;;N;DUP;87906103;88888213;CNV;982110
8;;N;DEL;88889108;88912585;CNV;23477
8;;N;DUP;89628493;93372462;CNV;3743969
8;;N;DUP;93377336;110315259;CNV;16937923
8;;N;DUP;110443376;116163109;CNV;5719733
8;;N;DUP;116206380;135894901;CNV;19688521
8;;N;DUP;135968328;142824280;CNV;6855952
9;;N;DUP;249391;316247;CNV;66856
9;;N;DUP;2177391;2177492;CNV;101
9;;N;DEL;2211628;3744144;CNV;1532516
9;;N;DEL;8159670;31831045;CNV;23671375
9;;N;DUP;31872064;68757198;CNV;36885134
9;;N;DUP;120884210;137995921;CNV;17111711
10;;N;DUP;67487209;81003449;CNV;13516240
10;;N;DEL;81222137;83489966;CNV;2267829
10;;N;DUP;92411094;93504750;CNV;1093656
11;;N;DUP;8783714;13296006;CNV;4512292
11;;N;DUP;19659584;20661604;CNV;1002020
11;;N;DUP;60655418;78215246;CNV;17559828
11;;N;DUP;82330805;83425835;CNV;1095030
11;;N;DEL;86669294;87182636;CNV;513342
12;;N;DUP;114256;166853;CNV;52597
12;;N;DEL;9926928;10094112;CNV;167184
12;;N;DEL;16163754;24944672;CNV;8780918
12;;N;DUP;30269916;33163183;CNV;2893267
12;;N;DUP;47553768;51754853;CNV;4201085
12;;N;DEL;51787414;51925467;CNV;138053
12;;N;DUP;52010834;58495833;CNV;6484999
12;;N;DUP;103971912;114029126;CNV;10057214
12;;N;DUP;114457991;132924025;CNV;18466034
13;;N;DUP;18848939;31232835;CNV;12383896
13;;N;DUP;32371400;34317348;CNV;1945948
13;;N;DEL;37780504;37910794;CNV;130290
13;;N;DUP;39009488;53423205;CNV;14413717
13;;N;DUP;57805364;61136368;CNV;3331004
13;;N;DUP;70122656;76015450;CNV;5892794
13;;N;DUP;76036704;94082682;CNV;18045978
13;;N;DUP;94082898;100824914;CNV;6742016
13;;N;DUP;100827105;105353853;CNV;4526748
13;;N;DUP;105361155;106515500;CNV;1154345
13;;N;DUP;106521939;109071912;CNV;2549973
13;;N;DUP;109179321;114267888;CNV;5088567
14;;N;DEL;19999171;20037032;CNV;37861
14;;N;DEL;20043514;20044613;CNV;1099
14;;N;DEL;21767650;21990456;CNV;222806
14;;N;DEL;25406676;30021156;CNV;4614480
14;;N;DEL;38233156;48045947;CNV;9812791
14;;N;DEL;61993089;62874078;CNV;880989
14;;N;DEL;78378985;79572531;CNV;1193546
14;;N;DEL;79594346;80871724;CNV;1277378
14;;N;DEL;98912731;98922042;CNV;9311
14;;N;DUP;98922410;106832764;CNV;7910354
15;;N;DUP;22869663;23779258;CNV;909595
15;;N;DUP;31089672;32724277;CNV;1634605
15;;N;DEL;32817753;32972107;CNV;154354
15;;N;DEL;33485504;34000434;CNV;514930
15;;N;DUP;34058712;34352442;CNV;293730
15;;N;DEL;34639371;34801031;CNV;161660
15;;N;DEL;34860448;38055276;CNV;3194828
16;;N;DEL;61896041;77626700;CNV;15730659
17;;N;DEL;10458952;14671023;CNV;4212071
17;;N;DUP;27336553;51934409;CNV;24597856
18;;N;DEL;36996827;43434517;CNV;6437690
18;;N;DEL;43490441;53901356;CNV;10410915
18;;N;DEL;53934458;53935338;CNV;880
18;;N;DEL;53937752;57497315;CNV;3559563
18;;N;DEL;60191569;61449973;CNV;1258404
18;;N;DEL;62068227;63496899;CNV;1428672
18;;N;DEL;63530560;73578850;CNV;10048290
19;;N;DUP;31870525;34891330;CNV;3020805
19;;N;DUP;35307013;50947673;CNV;15640660
20;;N;DEL;6147554;17378133;CNV;11230579
20;;N;DUP;26219007;26227269;CNV;8262
20;;N;DUP;31258500;38359006;CNV;7100506
20;;N;DUP;38477514;43579005;CNV;5101491
20;;N;DUP;43584147;46482318;CNV;2898171
20;;N;DUP;46557483;47008524;CNV;451041
20;;N;DUP;47044945;51140869;CNV;4095924
20;;N;DUP;51337175;64240906;CNV;12903731
21;;N;DEL;10494342;18697646;CNV;8203304
21;;N;DEL;18716841;25510394;CNV;6793553
21;;N;DEL;25547104;30787962;CNV;5240858
21;;N;DUP;36810131;37159569;CNV;349438
21;;N;DEL;37166817;38261465;CNV;1094648
21;;N;DEL;39799817;41038939;CNV;1239122
1;;N;DEL;67865246;88771395;CNV;20906149
1;;N;DEL;95522418;107715643;CNV;12193225
1;;N;DEL;119674510;119686494;CNV;11984
1;;N;DEL;119687456;119791105;CNV;103649
1;;N;DEL;162922857;162923486;CNV;629
1;;N;DUP;248436750;248655165;CNV;218415
2;;N;DEL;34249406;34318083;CNV;68677
2;;N;DEL;34321604;45631569;CNV;11309965
2;;N;DEL;57048839;58271346;CNV;1222507
2;;N;DEL;75118069;76560052;CNV;1441983
2;;N;DUP;102224047;114508979;CNV;12284932
2;;N;DUP;163455896;179645649;CNV;16189753
3;;N;DUP;119131;40766170;CNV;40647039
3;;N;DEL;40859765;40860493;CNV;728
3;;N;DUP;41082021;52433306;CNV;11351285
3;;N;DUP;195126921;197336437;CNV;2209516
4;;N;DEL;20201596;37560661;CNV;17359065
4;;N;DEL;54899878;129755920;CNV;74856042
4;;N;DEL;129770639;137213427;CNV;7442788
4;;N;DEL;137239398;182582458;CNV;45343060
4;;N;DUP;182634486;184512851;CNV;1878365
5;;N;DEL;56824819;62122840;CNV;5298021
5;;N;DEL;83689920;126192299;CNV;42502379
6;;N;DEL;1757945;2157653;CNV;399708
6;;N;DEL;47787344;51866975;CNV;4079631
6;;N;DEL;53113605;53289156;CNV;175551
6;;N;DUP;53389313;170543473;CNV;117154160
7;;N;DUP;1494152;22629738;CNV;21135586
7;;N;DUP;22716381;78938326;CNV;56221945
7;;N;DUP;79003173;86993467;CNV;7990294
7;;N;DEL;86993984;87000226;CNV;6242
7;;N;DUP;87061316;90982306;CNV;3920990
7;;N;DUP;107053837;108346641;CNV;1292804
7;;N;DEL;137119929;137359963;CNV;240034
7;;N;DUP;137874944;138008252;CNV;133308
7;;N;DUP;142703071;159262480;CNV;16559409
8;;N;DEL;1083625;3597214;CNV;2513589
8;;N;DEL;3619761;6018487;CNV;2398726
8;;N;DEL;6018538;13593152;CNV;7574614
8;;N;DEL;13667802;14721296;CNV;1053494
8;;N;DEL;14729084;14915678;CNV;186594
8;;N;DEL;14916034;16573953;CNV;1657919
8;;N;DEL;16579752;30320453;CNV;13740701
8;;N;DUP;30353003;30750071;CNV;397068
8;;N;DEL;30836637;36867307;CNV;6030670
8;;N;DEL;38806656;40443369;CNV;1636713
8;;N;DEL;42037795;43300036;CNV;1262241
9;;N;DEL;348205;25722616;CNV;25374411
9;;N;DUP;25743022;28355203;CNV;2612181
9;;N;DEL;28356133;29156012;CNV;799879
9;;N;DEL;29732110;31678990;CNV;1946880
9;;N;DUP;31831045;31983588;CNV;152543
9;;N;DEL;32017243;32121630;CNV;104387
9;;N;DUP;32161994;69231867;CNV;37069873
9;;N;DUP;108857739;114468911;CNV;5611172
10;;N;DEL;50254585;67973425;CNV;17718840
10;;N;DEL;78226595;81003449;CNV;2776854
10;;N;DEL;81222137;82269108;CNV;1046971
10;;N;DEL;82289009;84704831;CNV;2415822
10;;N;DEL;85054000;90503620;CNV;5449620
10;;N;DUP;92411094;93410356;CNV;999262
10;;N;DUP;121651831;122983684;CNV;1331853
11;;N;DUP;1961088;12924656;CNV;10963568
11;;N;DUP;44528276;48036761;CNV;3508485
11;;N;DEL;48224784;56777269;CNV;8552485
11;;N;DEL;79634818;107269821;CNV;27635003
11;;N;DEL;121249421;129041538;CNV;7792117
11;;N;DEL;129091800;131522794;CNV;2430994
11;;N;DEL;132341219;134707739;CNV;2366520
12;;N;DUP;114256;682044;CNV;567788
12;;N;DUP;892853;1428176;CNV;535323
12;;N;DUP;1491812;5104492;CNV;3612680
12;;N;DEL;9511756;9594870;CNV;83114
12;;N;DEL;15749048;24708242;CNV;8959194
12;;N;DEL;26485024;30258366;CNV;3773342
12;;N;DEL;33302705;33813561;CNV;510856
12;;N;DEL;33962969;39105086;CNV;5142117
12;;N;DEL;39118922;97215324;CNV;58096402
12;;N;DEL;114086628;114768560;CNV;681932
13;;N;DUP;18848939;31139405;CNV;12290466
13;;N;DUP;31140878;41823215;CNV;10682337
13;;N;DUP;41906037;53178046;CNV;11272009
13;;N;DUP;67143774;85667653;CNV;18523879
13;;N;DUP;90115362;105819679;CNV;15704317
13;;N;DUP;105895666;105896531;CNV;865
13;;N;DUP;105928373;114267888;CNV;8339515
14;;N;DEL;19747289;62874078;CNV;43126789
14;;N;DEL;79046830;88229366;CNV;9182536
15;;N;DUP;20743076;32724277;CNV;11981201
15;;N;DUP;38288041;45844625;CNV;7556584
15;;N;DUP;68983649;74050989;CNV;5067340
15;;N;DUP;87990258;91161552;CNV;3171294
15;;N;DEL;91182365;101824457;CNV;10642092
16;;N;DUP;215160;5524271;CNV;5309111
16;;N;DUP;5877234;6191182;CNV;313948
16;;N;DUP;8385143;12526972;CNV;4141829
16;;N;DUP;13839606;51067585;CNV;37227979
16;;N;DUP;51096222;51467515;CNV;371293
16;;N;DUP;51527644;75959329;CNV;24431685
16;;N;DEL;75980490;76012320;CNV;31830
16;;N;DUP;76128092;78867826;CNV;2739734
16;;N;DEL;78877204;78917866;CNV;40662
16;;N;DUP;78974884;83459689;CNV;4484805
16;;N;DUP;83615165;89774300;CNV;6159135
17;;N;DUP;601219;7028821;CNV;6427602
17;;N;DUP;27160113;35619562;CNV;8459449
17;;N;DUP;35627508;37795783;CNV;2168275
17;;N;DUP;37810887;41002125;CNV;3191238
17;;N;DUP;72588188;82630699;CNV;10042511
18;;N;DEL;26138645;54937957;CNV;28799312
18;;N;DEL;54976368;59718725;CNV;4742357
18;;N;DEL;59785871;75762781;CNV;15976910
18;;N;DEL;75968143;76103286;CNV;135143
18;;N;DEL;76103583;80087573;CNV;3983990
19;;N;DUP;390341;30452770;CNV;30062429
19;;N;DUP;30587312;58234565;CNV;27647253
20;;N;DUP;167044;6257494;CNV;6090450
20;;N;DUP;6418847;8584320;CNV;2165473
20;;N;DUP;8619458;14530522;CNV;5911064
20;;N;DEL;14749223;15086761;CNV;337538
20;;N;DUP;15717380;31259815;CNV;15542435
20;;N;DUP;31316342;33222046;CNV;1905704
20;;N;DUP;33339555;33868060;CNV;528505
20;;N;DUP;33930548;45751630;CNV;11821082
20;;N;DUP;46008271;64240906;CNV;18232635
21;;N;DEL;10494342;31975122;CNV;21480780
21;;N;DUP;32033387;33981573;CNV;1948186
21;;N;DUP;35145377;35145859;CNV;482
21;;N;DEL;36563890;36826015;CNV;262125
21;;N;DUP;36826159;37159569;CNV;333410
21;;N;DUP;38869358;46680243;CNV;7810885
1;;N;DEL;911484;18555486;CNV;17644002
1;;N;DEL;177393426;177394281;CNV;855
1;;N;DEL;236132716;248655165;CNV;12522449
2;;N;DUP;50310328;50311189;CNV;861
2;;N;DUP;50313339;56130447;CNV;5817108
2;;N;DEL;56145873;56146200;CNV;327
2;;N;DUP;56180912;58986443;CNV;2805531
2;;N;DEL;59033172;59085005;CNV;51833
2;;N;DUP;146146286;198038185;CNV;51891899
3;;N;DEL;119131;86488484;CNV;86369353
4;;N;DEL;155755096;155755406;CNV;310
5;;N;DEL;51492772;58428965;CNV;6936193
5;;N;DEL;59966159;68364812;CNV;8398653
5;;N;DEL;68365120;83268997;CNV;14903877
5;;N;DEL;83294231;86043371;CNV;2749140
5;;N;DEL;90706779;90764965;CNV;58186
5;;N;DEL;92570895;112904462;CNV;20333567
5;;N;DEL;118566086;120246072;CNV;1679986
5;;N;DEL;144673773;146443578;CNV;1769805
6;;N;DUP;54696503;54759849;CNV;63346
6;;N;DUP;100648600;145112099;CNV;44463499
6;;N;DEL;161961702;162331018;CNV;369316
7;;N;DUP;1494152;40689011;CNV;39194859
7;;N;DUP;40709051;78167602;CNV;37458551
7;;N;DUP;78275421;88762444;CNV;10487023
7;;N;DUP;88765031;88765569;CNV;538
7;;N;DUP;88797522;159262480;CNV;70464958
8;;N;DUP;35838032;36562646;CNV;724614
8;;N;DEL;36651697;43300036;CNV;6648339
8;;N;DUP;43338564;142824280;CNV;99485716
10;;N;DEL;128414306;129001973;CNV;587667
11;;N;DEL;112169304;127596868;CNV;15427564
12;;N;DUP;114256;9171109;CNV;9056853
12;;N;DUP;9199863;10712155;CNV;1512292
12;;N;DUP;10883384;40195305;CNV;29311921
16;;N;DUP;19218340;19336869;CNV;118529
18;;N;DEL;159885;3320160;CNV;3160275
18;;N;DEL;3347815;75083673;CNV;71735858
18;;N;DEL;75153209;75706428;CNV;553219
20;;N;DEL;167044;14496230;CNV;14329186
20;;N;DEL;14523097;14925213;CNV;402116
20;;N;DEL;15072421;15629740;CNV;557319
20;;N;DEL;15670566;25526859;CNV;9856293
20;;N;DUP;26159564;64240906;CNV;38081342
1;;N;DEL;227056783;227212352;CNV;155569
4;;N;DEL;67674053;67845124;CNV;171071
4;;N;DEL;118891042;118891184;CNV;142
10;;N;DUP;5099097;5159622;CNV;60525
13;;N;DUP;107471973;114267888;CNV;6795915
14;;N;DUP;19747289;19952526;CNV;205237
16;;N;DEL;6061072;6851397;CNV;790325
1;;N;DEL;6884744;39850216;CNV;32965472
1;;N;DEL;59768075;115783306;CNV;56015231
1;;N;DEL;183730883;199391849;CNV;15660966
1;;N;DEL;208801804;208941027;CNV;139223
1;;N;DUP;218573298;218653385;CNV;80087
2;;N;DUP;110819;142559591;CNV;142448772
2;;N;DUP;158598277;159745359;CNV;1147082
2;;N;DUP;226913729;227200517;CNV;286788
5;;N;DEL;45739965;168903446;CNV;123163481
5;;N;DUP;168942793;180644249;CNV;11701456
6;;N;DUP;205610;47896376;CNV;47690766
6;;N;DUP;165652172;170543473;CNV;4891301
7;;N;DUP;1494152;20597415;CNV;19103263
7;;N;DUP;20597809;40689011;CNV;20091202
7;;N;DUP;40709051;66956156;CNV;26247105
7;;N;DUP;67058437;78697983;CNV;11639546
8;;N;DEL;240568;11428637;CNV;11188069
8;;N;DUP;11527204;11813532;CNV;286328
8;;N;DEL;11963930;14391691;CNV;2427761
8;;N;DEL;14438328;16573953;CNV;2135625
8;;N;DEL;16579752;31930818;CNV;15351066
8;;N;DEL;31945942;37023284;CNV;5077342
8;;N;DUP;37069431;142824280;CNV;105754849
9;;N;DUP;249391;864834;CNV;615443
9;;N;DUP;3744144;4315442;CNV;571298
9;;N;DEL;28855513;29569472;CNV;713959
10;;N;DUP;223755;5011956;CNV;4788201
10;;N;DUP;5164133;16645245;CNV;11481112
10;;N;DUP;16821162;19001781;CNV;2180619
10;;N;DUP;19052030;20797575;CNV;1745545
10;;N;DUP;20811126;21124380;CNV;313254
10;;N;DUP;21800075;51145643;CNV;29345568
11;;N;DEL;121660179;121788251;CNV;128072
12;;N;DUP;114256;29113285;CNV;28999029
12;;N;DUP;29118872;29610333;CNV;491461
12;;N;DUP;30258366;32777444;CNV;2519078
12;;N;DUP;33042280;33813561;CNV;771281
13;;N;DUP;18848939;30908057;CNV;12059118
13;;N;DUP;30908104;53116314;CNV;22208210
13;;N;DUP;53177401;67174710;CNV;13997309
13;;N;DUP;67207096;114267888;CNV;47060792
14;;N;DEL;78410404;88229366;CNV;9818962
16;;N;DUP;51096222;51434981;CNV;338759
17;;N;DUP;27132035;28677685;CNV;1545650
17;;N;DUP;29048821;36062058;CNV;7013237
17;;N;DUP;36631986;37810887;CNV;1178901
17;;N;DEL;37815140;39297364;CNV;1482224
17;;N;DUP;39305390;41002125;CNV;1696735
17;;N;DUP;41036545;51636912;CNV;10600367
18;;N;DEL;159885;25842615;CNV;25682730
18;;N;DEL;25847680;42968039;CNV;17120359
18;;N;DEL;43094576;56670165;CNV;13575589
18;;N;DEL;56677230;59927632;CNV;3250402
18;;N;DEL;60191569;73578850;CNV;13387281
18;;N;DEL;73586431;80087573;CNV;6501142
19;;N;DUP;13454051;13474041;CNV;19990
19;;N;DUP;14632112;22560056;CNV;7927944
19;;N;DUP;22993469;48362957;CNV;25369488
20;;N;DUP;167044;6921524;CNV;6754480
20;;N;DEL;14530522;14802096;CNV;271574
20;;N;DEL;14868013;15239355;CNV;371342
20;;N;DEL;15243016;15671242;CNV;428226
20;;N;DUP;15671503;20276376;CNV;4604873
20;;N;DUP;20358666;22777322;CNV;2418656
20;;N;DUP;31258500;64240906;CNV;32982406
21;;N;DUP;10494342;13198753;CNV;2704411
21;;N;DEL;13280587;18839836;CNV;5559249
21;;N;DEL;18842097;30787962;CNV;11945865
21;;N;DEL;30814461;46680243;CNV;15865782
1;;N;DEL;79898391;79899677;CNV;1286
2;;N;DUP;110819;199678;CNV;88859
4;;N;DEL;160286226;160957840;CNV;671614
4;;N;DEL;162765620;189795030;CNV;27029410
5;;N;DUP;4786152;9109496;CNV;4323344
5;;N;DUP;9121479;9200428;CNV;78949
5;;N;DUP;9215219;18469349;CNV;9254130
5;;N;DEL;20124421;21273734;CNV;1149313
5;;N;DUP;23290034;24627993;CNV;1337959
5;;N;DEL;29209176;30085953;CNV;876777
5;;N;DUP;30164369;33603654;CNV;3439285
5;;N;DUP;33747482;54037647;CNV;20290165
5;;N;DUP;54306727;55179669;CNV;872942
5;;N;DEL;55406731;180644249;CNV;125237518
6;;N;DUP;205610;58290405;CNV;58084795
6;;N;DUP;70203131;72017341;CNV;1814210
6;;N;DUP;150590233;150847466;CNV;257233
7;;N;DUP;1494152;3309993;CNV;1815841
7;;N;DUP;3311672;54796575;CNV;51484903
7;;N;DUP;54934939;159262480;CNV;104327541
8;;N;DEL;1019343;3597059;CNV;2577716
8;;N;DEL;3597214;6096213;CNV;2498999
8;;N;DEL;6138390;12969304;CNV;6830914
8;;N;DEL;13000247;18561931;CNV;5561684
8;;N;DEL;18689574;30925139;CNV;12235565
8;;N;DEL;30925194;54787063;CNV;23861869
8;;N;DEL;54808736;54833659;CNV;24923
8;;N;DEL;54833796;56740469;CNV;1906673
8;;N;DUP;116091117;142824280;CNV;26733163
9;;N;DEL;249391;16645244;CNV;16395853
9;;N;DUP;16695692;18654353;CNV;1958661
9;;N;DUP;32257428;39015657;CNV;6758229
9;;N;DUP;132300188;137995921;CNV;5695733
10;;N;DEL;83180123;90210361;CNV;7030238
12;;N;DUP;892853;1491858;CNV;599005
12;;N;DUP;1647476;1825754;CNV;178278
12;;N;DUP;1854782;16163754;CNV;14308972
12;;N;DUP;103971912;132924025;CNV;28952113
16;;N;DUP;13847495;21701422;CNV;7853927
16;;N;DUP;83773726;89774300;CNV;6000574
17;;N;DEL;601219;14110877;CNV;13509658
17;;N;DUP;14201940;15455352;CNV;1253412
17;;N;DEL;51510889;52551165;CNV;1040276
17;;N;DEL;52551625;56868833;CNV;4317208
17;;N;DEL;57051187;60063592;CNV;3012405
17;;N;DEL;60069548;71901869;CNV;11832321
17;;N;DEL;72169237;82630699;CNV;10461462
18;;N;DEL;24597495;36996827;CNV;12399332
18;;N;DEL;38405795;38594616;CNV;188821
18;;N;DEL;38851572;80087573;CNV;41236001
19;;N;DUP;15049170;17753643;CNV;2704473
19;;N;DEL;19408759;24189408;CNV;4780649
20;;N;DUP;167044;11916797;CNV;11749753
20;;N;DUP;11917146;15812400;CNV;3895254
20;;N;DUP;15914575;54869019;CNV;38954444
20;;N;DUP;54876770;56327342;CNV;1450572
20;;N;DUP;56370727;64240906;CNV;7870179
21;;N;DEL;13280587;22652481;CNV;9371894
21;;N;DEL;22720238;30858010;CNV;8137772
21;;N;DEL;30953046;41286559;CNV;10333513
22;;N;DEL;15438402;22152664;CNV;6714262
22;;N;DEL;22326954;36537621;CNV;14210667
1;;N;DEL;12792723;68826786;CNV;56034063
1;;N;DEL;68966361;107715643;CNV;38749282
1;;N;DEL;107787734;119791105;CNV;12003371
1;;N;DUP;119916301;169232329;CNV;49316028
1;;N;DEL;169367379;169743456;CNV;376077
1;;N;DUP;169782529;189620464;CNV;19837935
1;;N;DUP;244144472;248655165;CNV;4510693
2;;N;DUP;110819;70494923;CNV;70384104
2;;N;DUP;108129765;114501486;CNV;6371721
3;;N;DUP;8561797;14815586;CNV;6253789
4;;N;DEL;10125607;48916378;CNV;38790771
4;;N;DUP;51818725;153098916;CNV;101280191
4;;N;DEL;153112175;155386292;CNV;2274117
4;;N;DUP;155494043;157195953;CNV;1701910
4;;N;DEL;157241868;158515780;CNV;1273912
4;;N;DUP;158831513;159093324;CNV;261811
4;;N;DEL;159401193;189795030;CNV;30393837
5;;N;DUP;207389;16879824;CNV;16672435
5;;N;DUP;31317422;45741021;CNV;14423599
5;;N;DEL;46251985;168942793;CNV;122690808
5;;N;DEL;169058965;180644249;CNV;11585284
6;;N;DEL;205610;47755941;CNV;47550331
6;;N;DEL;47787344;130327031;CNV;82539687
6;;N;DEL;130382888;162176920;CNV;31794032
6;;N;DEL;162240958;162354809;CNV;113851
6;;N;DEL;162423434;170543473;CNV;8120039
7;;N;DUP;1494152;8354618;CNV;6860466
7;;N;DUP;8382034;20598098;CNV;12216064
7;;N;DUP;20701544;63073187;CNV;42371643
7;;N;DEL;63375308;78547680;CNV;15172372
7;;N;DEL;78599234;93501505;CNV;14902271
7;;N;DEL;93501685;93510175;CNV;8490
7;;N;DEL;93524748;148124307;CNV;54599559
7;;N;DEL;148230187;159262480;CNV;11032293
8;;N;DEL;240568;3624871;CNV;3384303
8;;N;DEL;3625047;6018538;CNV;2393491
8;;N;DEL;6023894;14168744;CNV;8144850
8;;N;DEL;14208078;14415891;CNV;207813
8;;N;DEL;14438328;15787050;CNV;1348722
8;;N;DEL;15798177;15941399;CNV;143222
8;;N;DEL;34186686;35398564;CNV;1211878
8;;N;DUP;49143528;115685625;CNV;66542097
8;;N;DUP;116015269;142824280;CNV;26809011
9;;N;DEL;348205;4483189;CNV;4134984
10;;N;DEL;25586788;25587829;CNV;1041
10;;N;DEL;51488806;51514349;CNV;25543
10;;N;DEL;65714215;65875140;CNV;160925
10;;N;DUP;67651205;72884799;CNV;5233594
11;;N;DUP;98146294;98212912;CNV;66618
12;;N;DEL;78146107;79198605;CNV;1052498
12;;N;DUP;80856800;81674860;CNV;818060
12;;N;DUP;91775638;132924025;CNV;41148387
13;;N;DUP;18848939;53178046;CNV;34329107
13;;N;DUP;53178205;94764181;CNV;41585976
13;;N;DUP;94782871;114267888;CNV;19485017
14;;N;DEL;19747289;63182087;CNV;43434798
14;;N;DEL;63251114;78378985;CNV;15127871
14;;N;DEL;78410404;79611605;CNV;1201201
14;;N;DEL;79611895;80871724;CNV;1259829
14;;N;DEL;80897298;82196061;CNV;1298763
14;;N;DEL;82213324;88229304;CNV;6015980
16;;N;DEL;215160;12355921;CNV;12140761
16;;N;DUP;12367560;15061041;CNV;2693481
16;;N;DUP;23334385;29644889;CNV;6310504
16;;N;DEL;51527644;83453711;CNV;31926067
19;;N;DUP;390341;24189408;CNV;23799067
19;;N;DUP;56552547;58234565;CNV;1682018
20;;N;DUP;5862794;14300436;CNV;8437642
20;;N;DUP;14495402;15717103;CNV;1221701
20;;N;DUP;15717380;17376928;CNV;1659548
20;;N;DUP;17378133;64240906;CNV;46862773
1;;N;DUP;16259323;63694575;CNV;47435252
1;;N;DUP;153490975;169232329;CNV;15741354
1;;N;DUP;169367379;170374231;CNV;1006852
1;;N;DUP;170863701;177394281;CNV;6530580
1;;N;DUP;177456199;179535175;CNV;2078976
1;;N;DUP;179542519;184944870;CNV;5402351
1;;N;DUP;184969090;185619352;CNV;650262
1;;N;DUP;185630851;199391849;CNV;13760998
1;;N;DUP;199441844;223259617;CNV;23817773
1;;N;DUP;236798055;248655165;CNV;11857110
2;;N;DUP;8026388;11524223;CNV;3497835
2;;N;DUP;108127255;114501486;CNV;6374231
2;;N;DEL;150638026;150641872;CNV;3846
2;;N;DUP;158598277;159869437;CNV;1271160
4;;N;DEL;415163;7782467;CNV;7367304
4;;N;DEL;7802538;32016212;CNV;24213674
5;;N;DEL;91436248;123410039;CNV;31973791
6;;N;DEL;66412192;66418947;CNV;6755
6;;N;DEL;75191283;75192666;CNV;1383
6;;N;DEL;76709382;76710065;CNV;683
6;;N;DEL;93253683;93493468;CNV;239785
6;;N;DEL;112455209;112859356;CNV;404147
7;;N;DEL;3651647;3692849;CNV;41202
8;;N;DUP;240568;17354624;CNV;17114056
8;;N;DEL;82811813;83820269;CNV;1008456
8;;N;DEL;84665982;87906103;CNV;3240121
8;;N;DEL;88077198;89659156;CNV;1581958
8;;N;DEL;89760538;92660248;CNV;2899710
8;;N;DEL;92864592;93079537;CNV;214945
8;;N;DEL;93139859;96510359;CNV;3370500
9;;N;DUP;249391;518675;CNV;269284
10;;N;DEL;119062113;119062521;CNV;408
11;;N;DEL;64434456;72498016;CNV;8063560
11;;N;DEL;112199968;117128509;CNV;4928541
12;;N;DEL;4669921;4776938;CNV;107017
12;;N;DEL;48293579;48965097;CNV;671518
13;;N;DEL;47147280;53116314;CNV;5969034
13;;N;DEL;61157234;67129055;CNV;5971821
16;;N;DEL;67358124;87335972;CNV;19977848
16;;N;DUP;87685090;89774300;CNV;2089210
17;;N;DUP;31541429;42993510;CNV;11452081
17;;N;DEL;46186599;47264763;CNV;1078164
21;;N;DEL;36563890;36564340;CNV;450
22;;N;DUP;15438402;19646807;CNV;4208405
22;;N;DUP;35235551;50242600;CNV;15007049
1;;N;DEL;911484;29119002;CNV;28207518
1;;N;DUP;104317275;104423857;CNV;106582
1;;N;DEL;248436750;248655165;CNV;218415
2;;N;DUP;110819;240630;CNV;129811
2;;N;DUP;40690408;41091424;CNV;401016
2;;N;DEL;53260179;53697591;CNV;437412
2;;N;DUP;81465673;81905816;CNV;440143
2;;N;DUP;97883349;97883754;CNV;405
2;;N;DUP;114794355;240942225;CNV;126147870
3;;N;DUP;76831661;177672827;CNV;100841166
4;;N;DEL;415163;42898545;CNV;42483382
4;;N;DUP;124611083;133096754;CNV;8485671
4;;N;DUP;133309621;134369230;CNV;1059609
4;;N;DEL;134427205;189795030;CNV;55367825
5;;N;DEL;96625036;96743323;CNV;118287
5;;N;DEL;103284973;114701117;CNV;11416144
6;;N;DEL;205610;20975153;CNV;20769543
7;;N;DUP;3258621;54662746;CNV;51404125
7;;N;DUP;54708949;88762444;CNV;34053495
7;;N;DUP;88765031;88883727;CNV;118696
8;;N;DEL;14208078;15210471;CNV;1002393
8;;N;DEL;15251698;34186686;CNV;18934988
8;;N;DEL;139288422;142824280;CNV;3535858
9;;N;DUP;249391;31831045;CNV;31581654
9;;N;DUP;101998322;103559973;CNV;1561651
10;;N;DEL;223755;51790629;CNV;51566874
10;;N;DEL;60845098;64710091;CNV;3864993
10;;N;DUP;64710620;65028292;CNV;317672
10;;N;DEL;65228859;78716768;CNV;13487909
10;;N;DEL;90675696;128406886;CNV;37731190
10;;N;DEL;128414306;128571626;CNV;157320
10;;N;DEL;128626171;133526341;CNV;4900170
11;;N;DUP;23272637;23273134;CNV;497
11;;N;DUP;82297629;82330805;CNV;33176
11;;N;DUP;97318426;98351856;CNV;1033430
11;;N;DEL;113748617;123679016;CNV;9930399
11;;N;DEL;126939118;127486377;CNV;547259
12;;N;DUP;15107629;47100346;CNV;31992717
12;;N;DEL;56450565;56937957;CNV;487392
12;;N;DUP;80329979;81595558;CNV;1265579
12;;N;DUP;82000375;82022535;CNV;22160
12;;N;DUP;85077619;87721275;CNV;2643656
12;;N;DEL;87801152;88776317;CNV;975165
12;;N;DUP;88857031;89368722;CNV;511691
13;;N;DUP;18848939;22287782;CNV;3438843
13;;N;DUP;22308318;22487767;CNV;179449
13;;N;DUP;25692740;29455585;CNV;3762845
13;;N;DUP;29455681;33048558;CNV;3592877
13;;N;DUP;53779427;61819450;CNV;8040023
13;;N;DUP;61833371;61861119;CNV;27748
13;;N;DUP;61872425;87577000;CNV;25704575
13;;N;DUP;87591381;114267888;CNV;26676507
14;;N;DEL;19747289;23713387;CNV;3966098
14;;N;DUP;23755318;23755826;CNV;508
14;;N;DUP;31872700;31885927;CNV;13227
14;;N;DUP;42402683;47293546;CNV;4890863
14;;N;DEL;47294497;106832764;CNV;59538267
16;;N;DEL;4503191;6690028;CNV;2186837
17;;N;DEL;15013787;46040031;CNV;31026244
18;;N;DEL;159885;677931;CNV;518046
18;;N;DEL;2800827;3320160;CNV;519333
18;;N;DEL;3347815;28411232;CNV;25063417
18;;N;DEL;33103958;34549273;CNV;1445315
18;;N;DEL;34551933;38913496;CNV;4361563
18;;N;DEL;38913547;43776524;CNV;4862977
18;;N;DEL;43802061;48333297;CNV;4531236
18;;N;DEL;48359963;50129023;CNV;1769060
18;;N;DEL;75162349;75698406;CNV;536057
18;;N;DEL;75706428;80087573;CNV;4381145
20;;N;DUP;167044;15086761;CNV;14919717
20;;N;DUP;15111948;15427231;CNV;315283
20;;N;DUP;15435267;64240906;CNV;48805639
22;;N;DEL;15438402;22129955;CNV;6691553
22;;N;DUP;22150929;22151181;CNV;252
22;;N;DEL;22151947;26401726;CNV;4249779
22;;N;DEL;33598044;50242600;CNV;16644556
1;;N;DEL;911484;34765777;CNV;33854293
1;;N;DUP;34803928;34805126;CNV;1198
1;;N;DUP;104439887;107936465;CNV;3496578
2;;N;DUP;48065724;50291196;CNV;2225472
2;;N;DEL;50313339;50538869;CNV;225530
2;;N;DUP;50539000;50698949;CNV;159949
2;;N;DUP;50745944;52935920;CNV;2189976
2;;N;DUP;161319533;165951253;CNV;4631720
3;;N;DUP;153322400;153323214;CNV;814
3;;N;DEL;186677324;187270153;CNV;592829
4;;N;DEL;415163;10635217;CNV;10220054
4;;N;DUP;88997478;88997817;CNV;339
4;;N;DUP;131145219;133096754;CNV;1951535
4;;N;DUP;133309621;134112327;CNV;802706
4;;N;DEL;182901076;189795030;CNV;6893954
5;;N;DEL;207389;8385975;CNV;8178586
5;;N;DEL;77482660;77513235;CNV;30575
6;;N;DUP;44574148;45623112;CNV;1048964
6;;N;DEL;45774769;47024322;CNV;1249553
6;;N;DUP;100743803;103384860;CNV;2641057
6;;N;DUP;106534657;106536794;CNV;2137
6;;N;DUP;110982539;110982771;CNV;232
7;;N;DUP;54642285;54649836;CNV;7551
7;;N;DUP;81495348;88762444;CNV;7267096
7;;N;DUP;88765031;89079189;CNV;314158
8;;N;DEL;557994;614419;CNV;56425
8;;N;DEL;664843;2161407;CNV;1496564
8;;N;DEL;4747844;14167640;CNV;9419796
8;;N;DUP;84222012;84222419;CNV;407
8;;N;DUP;125208657;128541299;CNV;3332642
8;;N;DUP;131651546;132175811;CNV;524265
8;;N;DEL;132269138;142824280;CNV;10555142
10;;N;DEL;67791707;78715619;CNV;10923912
10;;N;DEL;117162851;117259346;CNV;96495
10;;N;DEL;119211952;129102125;CNV;9890173
11;;N;DEL;113746266;123937773;CNV;10191507
11;;N;DUP;123947056;124408234;CNV;461178
11;;N;DEL;124448811;127486377;CNV;3037566
11;;N;DEL;133925122;134707739;CNV;782617
12;;N;DEL;114256;5638128;CNV;5523872
12;;N;DUP;77802439;78383765;CNV;581326
12;;N;DUP;85118589;89368722;CNV;4250133
13;;N;DUP;53779427;93512432;CNV;39733005
13;;N;DEL;93521435;93959525;CNV;438090
13;;N;DEL;109698002;114267888;CNV;4569886
14;;N;DEL;19747289;22644437;CNV;2897148
14;;N;DUP;31872700;31873496;CNV;796
14;;N;DEL;36816151;37299582;CNV;483431
14;;N;DEL;38777159;38928567;CNV;151408
14;;N;DUP;39035792;47293546;CNV;8257754
15;;N;DUP;34863204;35635668;CNV;772464
18;;N;DEL;159885;928868;CNV;768983
18;;N;DEL;44071482;54439198;CNV;10367716
18;;N;DEL;57692860;59448557;CNV;1755697
18;;N;DEL;75081762;75706428;CNV;624666
18;;N;DUP;75762781;76042009;CNV;279228
18;;N;DEL;76042821;80087573;CNV;4044752
19;;N;DUP;55492713;55818381;CNV;325668
19;;N;DEL;55861247;58234565;CNV;2373318
20;;N;DUP;14925213;15427231;CNV;502018
21;;N;DEL;27189203;27190454;CNV;1251
21;;N;DEL;31975122;39114581;CNV;7139459
21;;N;DUP;39127541;39226450;CNV;98909
21;;N;DEL;39265595;46680243;CNV;7414648
22;;N;DEL;33598044;44898562;CNV;11300518
22;;N;DEL;44996489;45322862;CNV;326373
22;;N;DEL;45362878;50242600;CNV;4879722
1;;N;DEL;911484;19174057;CNV;18262573
1;;N;DUP;101913616;105484742;CNV;3571126
1;;N;DEL;237759943;248655165;CNV;10895222
4;;N;DUP;92739516;92739807;CNV;291
5;;N;DEL;144623699;146443578;CNV;1819879
7;;N;DUP;8920666;46622817;CNV;37702151
10;;N;DUP;64734768;65028292;CNV;293524
12;;N;DUP;25818964;26092977;CNV;274013
12;;N;DUP;80363433;80705935;CNV;342502
13;;N;DUP;18848939;80141758;CNV;61292819
13;;N;DUP;80255489;84514431;CNV;4258942
13;;N;DEL;84517054;84534952;CNV;17898
13;;N;DUP;84598325;85698523;CNV;1100198
13;;N;DUP;85768314;109638479;CNV;23870165
13;;N;DEL;109698002;110512732;CNV;814730
14;;N;DEL;19747289;19941340;CNV;194051
14;;N;DEL;19952179;23713387;CNV;3761208
14;;N;DUP;23755318;23801783;CNV;46465
15;;N;DEL;94611102;94733422;CNV;122320
18;;N;DEL;3347815;80087573;CNV;76739758
20;;N;DUP;167044;2460006;CNV;2292962
20;;N;DUP;15131646;15173399;CNV;41753
20;;N;DUP;44658464;64240906;CNV;19582442
21;;N;DUP;23230166;23314543;CNV;84377
22;;N;DEL;33424270;50242600;CNV;16818330
6;;N;DUP;205610;170543473;CNV;170337863
8;;N;DEL;277598;3750620;CNV;3473022
8;;N;DEL;3790798;6055525;CNV;2264727
8;;N;DEL;6094820;26698878;CNV;20604058
8;;N;DUP;61056377;136755501;CNV;75699124
9;;N;DEL;23769756;23775451;CNV;5695
12;;N;DUP;114256;25618961;CNV;25504705
12;;N;DUP;25626182;26337222;CNV;711040
12;;N;DUP;26444100;82035813;CNV;55591713
20;;N;DUP;167044;8459863;CNV;8292819
20;;N;DEL;8482484;8489282;CNV;6798
20;;N;DUP;8560623;14495629;CNV;5935006
20;;N;DEL;14496230;14869207;CNV;372977
20;;N;DUP;14925213;15629740;CNV;704527
20;;N;DEL;15670252;15717103;CNV;46851
20;;N;DUP;15717380;64240906;CNV;48523526
21;;N;DEL;16402156;16402736;CNV;580
21;;N;DEL;23836840;24383918;CNV;547078
22;;N;DUP;35180738;39771138;CNV;4590400
1;;N;DEL;225015494;225306823;CNV;291329
3;;N;DEL;119131;11898056;CNV;11778925
8;;N;DUP;35575565;142824280;CNV;107248715
9;;N;DUP;249391;569992;CNV;320601
9;;N;DUP;101165004;108493752;CNV;7328748
9;;N;DUP;108908233;113995190;CNV;5086957
9;;N;DUP;119657389;137995921;CNV;18338532
10;;N;DUP;19650545;19650885;CNV;340
10;;N;DEL;80584920;100909099;CNV;20324179
12;;N;DUP;114256;4614480;CNV;4500224
12;;N;DUP;5640115;25618961;CNV;19978846
12;;N;DUP;25626182;26459137;CNV;832955
14;;N;DEL;65468187;95457333;CNV;29989146
16;;N;DUP;215160;4501504;CNV;4286344
16;;N;DEL;6445490;6690028;CNV;244538
17;;N;DEL;601219;27131847;CNV;26530628
17;;N;DUP;57651402;58725332;CNV;1073930
18;;N;DEL;27774067;80087573;CNV;52313506
19;;N;DUP;390341;16345449;CNV;15955108
19;;N;DUP;48362957;58234565;CNV;9871608
1;;N;DEL;66808227;74845673;CNV;8037446
1;;N;DEL;74994649;79265224;CNV;4270575
1;;N;DEL;79265725;85820776;CNV;6555051
1;;N;DEL;85864906;121458637;CNV;35593731
1;;N;DUP;148743186;248655165;CNV;99911979
4;;N;DUP;24538694;26076807;CNV;1538113
4;;N;DEL;33201393;37360520;CNV;4159127
4;;N;DEL;75816637;77291527;CNV;1474890
4;;N;DUP;86255292;90043936;CNV;3788644
4;;N;DEL;102178955;145672445;CNV;43493490
4;;N;DEL;147756460;163707692;CNV;15951232
4;;N;DEL;170142375;183923998;CNV;13781623
4;;N;DEL;185952690;189795030;CNV;3842340
5;;N;DUP;207389;44480915;CNV;44273526
5;;N;DEL;45249502;77369359;CNV;32119857
5;;N;DEL;77409256;77513235;CNV;103979
5;;N;DEL;103287744;107477992;CNV;4190248
5;;N;DEL;108952284;114760084;CNV;5807800
5;;N;DEL;114784899;179112399;CNV;64327500
6;;N;DEL;66412192;66413237;CNV;1045
6;;N;DEL;66638527;70859426;CNV;4220899
7;;N;DEL;1494152;4444798;CNV;2950646
7;;N;DEL;146874721;147046039;CNV;171318
9;;N;DEL;82815336;82815500;CNV;164
10;;N;DUP;223755;6874666;CNV;6650911
11;;N;DEL;37110704;56474785;CNV;19364081
12;;N;DUP;10094454;11807908;CNV;1713454
14;;N;DUP;90876337;92627079;CNV;1750742
14;;N;DUP;101536520;106832764;CNV;5296244
16;;N;DEL;6314278;6731002;CNV;416724
17;;N;DEL;601219;36689520;CNV;36088301
17;;N;DUP;36871359;41252818;CNV;4381459
17;;N;DEL;41285737;47264763;CNV;5979026
17;;N;DUP;51417214;51417448;CNV;234
17;;N;DEL;52022102;74816840;CNV;22794738
20;;N;DEL;167044;3015777;CNV;2848733
20;;N;DUP;3374581;6147576;CNV;2772995
20;;N;DUP;6251236;31258599;CNV;25007363
20;;N;DUP;31259815;64240906;CNV;32981091
21;;N;DUP;41263749;44780666;CNV;3516917
21;;N;DUP;44783726;45714069;CNV;930343
21;;N;DUP;45728323;46680243;CNV;951920
22;;N;DUP;15438402;24879426;CNV;9441024
1;;N;DEL;218944401;218944625;CNV;224
1;;N;DUP;234322728;235248733;CNV;926005
3;;N;DUP;46496528;51312456;CNV;4815928
4;;N;DEL;415163;2175158;CNV;1759995
8;;N;DEL;3597059;5963363;CNV;2366304
8;;N;DUP;38806656;40109539;CNV;1302883
8;;N;DEL;77594926;77639128;CNV;44202
10;;N;DUP;93391736;93410356;CNV;18620
10;;N;DEL;94815312;94816433;CNV;1121
13;;N;DUP;40121855;45612841;CNV;5490986
16;;N;DEL;6851512;7020642;CNV;169130
19;;N;DUP;31873240;34847352;CNV;2974112
20;;N;DUP;18905038;20177123;CNV;1272085
5;;N;DEL;46251985;175855340;CNV;129603355
6;;N;DEL;205610;28156691;CNV;27951081
6;;N;DUP;28200948;47896376;CNV;19695428
6;;N;DUP;74564762;102498549;CNV;27933787
6;;N;DUP;102551432;108018123;CNV;5466691
6;;N;DEL;110856802;119605587;CNV;8748785
6;;N;DUP;119637097;119704075;CNV;66978
6;;N;DEL;120979695;121515449;CNV;535754
6;;N;DEL;123311063;170543473;CNV;47232410
8;;N;DEL;240568;42074448;CNV;41833880
8;;N;DUP;43243912;50395966;CNV;7152054
8;;N;DUP;50409396;68769431;CNV;18360035
8;;N;DUP;68817334;142824280;CNV;74006946
10;;N;DUP;128313438;133526341;CNV;5212903
17;;N;DEL;601219;16631280;CNV;16030061
19;;N;DUP;390341;5423632;CNV;5033291
19;;N;DUP;24189408;47097344;CNV;22907936
19;;N;DEL;47509212;58234565;CNV;10725353
1;;N;DEL;227056783;228312926;CNV;1256143
4;;N;DEL;415163;2805182;CNV;2390019
4;;N;DEL;10181484;24793175;CNV;14611691
7;;N;DUP;1494152;88762444;CNV;87268292
7;;N;DUP;88797522;112455567;CNV;23658045
7;;N;DUP;112475603;159262480;CNV;46786877
12;;N;DUP;114256;132924025;CNV;132809769
20;;N;DUP;31354892;53879462;CNV;22524570
20;;N;DUP;58556863;59417834;CNV;860971
21;;N;DEL;18839836;18841604;CNV;1768
6;;N;DUP;15696384;15764444;CNV;68060
6;;N;DUP;16067793;16068339;CNV;546
6;;N;DUP;56634391;57126875;CNV;492484
6;;N;DUP;149398767;150696458;CNV;1297691
8;;N;DEL;4650042;6018538;CNV;1368496
10;;N;DEL;28738004;28745944;CNV;7940
10;;N;DUP;84704896;85002634;CNV;297738
10;;N;DUP;93391704;93410356;CNV;18652
14;;N;DEL;45353040;49198387;CNV;3845347
14;;N;DEL;86456762;86501528;CNV;44766
14;;N;DEL;86672222;88229366;CNV;1557144
15;;N;DEL;45880004;46948720;CNV;1068716
15;;N;DUP;57862714;58015183;CNV;152469
15;;N;DUP;66607515;66636150;CNV;28635
16;;N;DUP;215160;3342053;CNV;3126893
16;;N;DEL;6445490;6851512;CNV;406022
16;;N;DEL;6869983;7106381;CNV;236398
16;;N;DEL;7180500;7662414;CNV;481914
16;;N;DUP;57253106;59298271;CNV;2045165
16;;N;DUP;83459129;85786596;CNV;2327467
16;;N;DEL;85803416;85803818;CNV;402
19;;N;DUP;390341;16480653;CNV;16090312
1;;N;DEL;911484;5650383;CNV;4738899
1;;N;DEL;223644158;223644243;CNV;85
8;;N;DEL;240568;3625047;CNV;3384479
8;;N;DUP;3625109;4364040;CNV;738931
8;;N;DEL;4365170;35506013;CNV;31140843
8;;N;DUP;35557119;36562646;CNV;1005527
8;;N;DEL;36651697;41080132;CNV;4428435
8;;N;DUP;41379918;43338564;CNV;1958646
8;;N;DEL;46370071;52896896;CNV;6526825
8;;N;DUP;52911644;54049835;CNV;1138191
8;;N;DEL;54142555;79338979;CNV;25196424
8;;N;DUP;79585637;80934447;CNV;1348810
8;;N;DEL;81093404;81403770;CNV;310366
8;;N;DUP;81633202;81949796;CNV;316594
8;;N;DUP;85187707;86678520;CNV;1490813
8;;N;DEL;86745798;96954317;CNV;10208519
8;;N;DUP;97030697;98373968;CNV;1343271
8;;N;DUP;109122051;109758064;CNV;636013
8;;N;DEL;109793179;126430404;CNV;16637225
8;;N;DUP;126492408;127465915;CNV;973507
8;;N;DEL;128531151;142824280;CNV;14293129
10;;N;DEL;42461021;133526341;CNV;91065320
11;;N;DUP;1961088;13272358;CNV;11311270
11;;N;DEL;13276378;13289171;CNV;12793
11;;N;DUP;13295859;15963736;CNV;2667877
11;;N;DUP;16836682;50502274;CNV;33665592
17;;N;DEL;601219;35959741;CNV;35358522
20;;N;DUP;167044;15717380;CNV;15550336
20;;N;DUP;15755468;64240906;CNV;48485438
4;;N;DEL;69902928;69919756;CNV;16828
4;;N;DUP;70167346;81440142;CNV;11272796
7;;N;DUP;1494152;19287465;CNV;17793313
7;;N;DUP;19287807;47114962;CNV;27827155
8;;N;DEL;3750620;6018538;CNV;2267918
8;;N;DEL;16468462;16498751;CNV;30289
9;;N;DUP;19736358;30383203;CNV;10646845
9;;N;DUP;30451026;39015657;CNV;8564631
12;;N;DEL;9372344;9733403;CNV;361059
12;;N;DUP;9761409;9777083;CNV;15674
13;;N;DUP;19016196;45696465;CNV;26680269
13;;N;DUP;66729422;87476206;CNV;20746784
14;;N;DEL;19747289;20020032;CNV;272743
17;;N;DEL;601219;16932739;CNV;16331520
17;;N;DUP;17074496;22624646;CNV;5550150
17;;N;DEL;52298237;52736733;CNV;438496
17;;N;DEL;72989952;74703694;CNV;1713742
20;;N;DUP;40804179;60918647;CNV;20114468
5;;N;DEL;2231456;12970600;CNV;10739144
5;;N;DEL;43695339;46251985;CNV;2556646
5;;N;DEL;106804196;113140813;CNV;6336617
8;;N;DEL;240568;4632242;CNV;4391674
8;;N;DEL;4644964;6018487;CNV;1373523
8;;N;DEL;6018538;35838032;CNV;29819494
8;;N;DUP;35838086;142824280;CNV;106986194
10;;N;DEL;66409196;66458002;CNV;48806
12;;N;DUP;24791051;26092977;CNV;1301926
12;;N;DEL;84627748;84787219;CNV;159471
17;;N;DEL;5900755;22624646;CNV;16723891
19;;N;DEL;45824451;58234565;CNV;12410114
20;;N;DEL;167044;26219392;CNV;26052348
20;;N;DUP;26227269;64240906;CNV;38013637
22;;N;DEL;38003091;50242600;CNV;12239509
3;;N;DEL;26477377;65755650;CNV;39278273
3;;N;DUP;94446140;148684266;CNV;54238126
3;;N;DEL;148685651;148687331;CNV;1680
3;;N;DUP;148771595;197336437;CNV;48564842
4;;N;DEL;415163;168487851;CNV;168072688
4;;N;DEL;168534857;189795030;CNV;21260173
5;;N;DEL;111895385;112832368;CNV;936983
8;;N;DUP;240568;465401;CNV;224833
8;;N;DUP;2498001;3958599;CNV;1460598
8;;N;DUP;3959148;6094820;CNV;2135672
9;;N;DUP;249391;137995921;CNV;137746530
17;;N;DEL;33591090;33772726;CNV;181636
17;;N;DUP;36062058;36111966;CNV;49908
17;;N;DEL;57281644;57478638;CNV;196994
17;;N;DUP;57651402;82630699;CNV;24979297
18;;N;DEL;31592074;54471441;CNV;22879367
18;;N;DEL;54476512;67623477;CNV;13146965
18;;N;DEL;67654579;80087573;CNV;12432994
4;;N;DEL;90189175;189795030;CNV;99605855
7;;N;DUP;2770844;63073187;CNV;60302343
8;;N;DEL;240568;37271022;CNV;37030454
8;;N;DUP;37479437;89279899;CNV;51800462
8;;N;DEL;89392363;89628493;CNV;236130
8;;N;DUP;89658452;142824280;CNV;53165828
10;;N;DEL;16199856;16275572;CNV;75716
15;;N;DEL;32906727;33168765;CNV;262038
16;;N;DEL;31718231;89774300;CNV;58056069
20;;N;DUP;167044;4720565;CNV;4553521
20;;N;DUP;4919196;14300436;CNV;9381240
20;;N;DEL;14495402;15086761;CNV;591359
20;;N;DUP;15111948;15629740;CNV;517792
20;;N;DUP;15717103;41601081;CNV;25883978
20;;N;DUP;41726448;64240906;CNV;22514458
21;;N;DEL;18839836;18842097;CNV;2261
1;;N;DEL;79899406;79899677;CNV;271
1;;N;DEL;79903557;84317871;CNV;4414314
1;;N;DEL;232318562;248655165;CNV;16336603
6;;N;DUP;205610;49405990;CNV;49200380
6;;N;DUP;167893240;170543473;CNV;2650233
7;;N;DUP;1494152;65899369;CNV;64405217
7;;N;DEL;66360926;87061316;CNV;20700390
7;;N;DUP;150440780;159262480;CNV;8821700
8;;N;DEL;240568;3809322;CNV;3568754
8;;N;DEL;3811129;6405310;CNV;2594181
8;;N;DEL;6405562;32669762;CNV;26264200
8;;N;DUP;40455711;142824280;CNV;102368569
9;;N;DUP;657092;1306304;CNV;649212
9;;N;DUP;119895709;131638191;CNV;11742482
9;;N;DEL;131744647;131943122;CNV;198475
9;;N;DUP;131999256;137995921;CNV;5996665
12;;N;DUP;45296318;50558239;CNV;5261921
12;;N;DUP;50614576;56450565;CNV;5835989
12;;N;DEL;81637014;91407606;CNV;9770592
18;;N;DEL;40811677;80087573;CNV;39275896
19;;N;DUP;27988563;58234565;CNV;30246002
20;;N;DUP;167044;4213047;CNV;4046003
20;;N;DUP;25068304;37830906;CNV;12762602
20;;N;DUP;37843352;42399347;CNV;4555995
20;;N;DUP;42406345;64240906;CNV;21834561
21;;N;DEL;13280587;18840127;CNV;5559540
21;;N;DEL;18840374;18842097;CNV;1723
21;;N;DEL;18842824;23224949;CNV;4382125
22;;N;DEL;40510631;50242600;CNV;9731969
1;;N;DEL;911484;56757563;CNV;55846079
1;;N;DEL;56772346;56772855;CNV;509
1;;N;DEL;56775561;119594822;CNV;62819261
1;;N;DEL;119674510;119674791;CNV;281
1;;N;DEL;119686494;119791105;CNV;104611
6;;N;DEL;93492888;93493316;CNV;428
6;;N;DUP;130410729;130573457;CNV;162728
6;;N;DUP;134415884;134417047;CNV;1163
8;;N;DUP;240568;142824280;CNV;142583712
10;;N;DEL;28738004;28739207;CNV;1203
10;;N;DEL;65228859;66458002;CNV;1229143
10;;N;DEL;80986730;84704831;CNV;3718101
11;;N;DUP;24848170;25100812;CNV;252642
12;;N;DUP;24791051;26337222;CNV;1546171
12;;N;DUP;30053308;33163183;CNV;3109875
14;;N;DUP;19747289;33241581;CNV;13494292
14;;N;DUP;33295362;33423756;CNV;128394
14;;N;DUP;62917116;79100358;CNV;16183242
14;;N;DUP;88427866;106832764;CNV;18404898
16;;N;DUP;215160;6690261;CNV;6475101
16;;N;DUP;7458956;8386012;CNV;927056
16;;N;DUP;8398576;12526972;CNV;4128396
16;;N;DUP;12543563;89774300;CNV;77230737
17;;N;DUP;601219;51510889;CNV;50909670
17;;N;DUP;54447260;82630699;CNV;28183439
20;;N;DUP;167044;15812400;CNV;15645356
20;;N;DUP;15914575;16269101;CNV;354526
20;;N;DUP;16271023;64240906;CNV;47969883
1;;N;DUP;148967478;248655165;CNV;99687687
8;;N;DEL;240568;43300036;CNV;43059468
8;;N;DUP;43338564;129000116;CNV;85661552
8;;N;DEL;129004138;129004253;CNV;115
8;;N;DUP;129009715;142824280;CNV;13814565
12;;N;DUP;67415454;132924025;CNV;65508571
13;;N;DUP;18848939;21437423;CNV;2588484
13;;N;DUP;25717607;31912709;CNV;6195102
13;;N;DUP;31986540;33168953;CNV;1182413
13;;N;DUP;33320464;34157924;CNV;837460
13;;N;DUP;34169577;34467019;CNV;297442
13;;N;DUP;34479850;34928301;CNV;448451
13;;N;DEL;35180360;75398710;CNV;40218350
13;;N;DEL;90715792;90824277;CNV;108485
18;;N;DUP;22499360;25336757;CNV;2837397
1;;N;DEL;911484;27645570;CNV;26734086
1;;N;DEL;46653246;148788368;CNV;102135122
2;;N;DUP;81611384;81617605;CNV;6221
2;;N;DUP;108472948;114508979;CNV;6036031
5;;N;DEL;207389;180644249;CNV;180436860
6;;N;DUP;205610;16068339;CNV;15862729
7;;N;DUP;1494152;57782762;CNV;56288610
8;;N;DEL;240568;28310209;CNV;28069641
8;;N;DUP;28475777;29390894;CNV;915117
8;;N;DUP;30198880;31547763;CNV;1348883
8;;N;DEL;31945942;33678519;CNV;1732577
8;;N;DEL;35032468;37023064;CNV;1990596
8;;N;DUP;41382428;69694927;CNV;28312499
8;;N;DUP;70034358;142824280;CNV;72789922
9;;N;DEL;249391;5318770;CNV;5069379
9;;N;DUP;5412867;5987781;CNV;574914
9;;N;DEL;6078763;25307813;CNV;19229050
9;;N;DUP;25352203;27583470;CNV;2231267
9;;N;DEL;27697337;32516951;CNV;4819614
9;;N;DEL;35279817;42295738;CNV;7015921
11;;N;DEL;1961088;8783760;CNV;6822672
11;;N;DUP;8796033;12992989;CNV;4196956
11;;N;DUP;12997671;30552042;CNV;17554371
12;;N;DEL;28303065;49684341;CNV;21381276
12;;N;DUP;49912365;50558239;CNV;645874
12;;N;DUP;53869758;56450565;CNV;2580807
12;;N;DEL;56732095;62321947;CNV;5589852
12;;N;DEL;64178445;68002355;CNV;3823910
12;;N;DEL;71955510;132924025;CNV;60968515
13;;N;DUP;18848939;29766893;CNV;10917954
13;;N;DUP;29774548;46837526;CNV;17062978
13;;N;DUP;46863081;53423205;CNV;6560124
13;;N;DUP;53429368;67174710;CNV;13745342
14;;N;DEL;100863372;101500054;CNV;636682
17;;N;DEL;40685410;62100143;CNV;21414733
18;;N;DEL;1570336;11712840;CNV;10142504
18;;N;DEL;22247510;56199372;CNV;33951862
18;;N;DEL;59785871;75792434;CNV;16006563
18;;N;DEL;76041456;80087573;CNV;4046117
19;;N;DEL;6552375;22501274;CNV;15948899
20;;N;DEL;13257067;15784522;CNV;2527455
20;;N;DUP;19203400;64240906;CNV;45037506
21;;N;DEL;10494342;30815413;CNV;20321071
1;;N;DUP;64094406;66617076;CNV;2522670
1;;N;DUP;95831030;108749712;CNV;12918682
5;;N;DUP;79397144;79753666;CNV;356522
5;;N;DEL;132345364;133473455;CNV;1128091
5;;N;DEL;133551847;180644249;CNV;47092402
6;;N;DUP;51927839;54156381;CNV;2228542
6;;N;DUP;54160357;56819921;CNV;2659564
6;;N;DUP;61215464;65685488;CNV;4470024
6;;N;DEL;65786217;65796270;CNV;10053
6;;N;DEL;65801033;170543473;CNV;104742440
8;;N;DEL;240568;28138849;CNV;27898281
8;;N;DUP;28165409;40098546;CNV;11933137
8;;N;DUP;40109539;42074448;CNV;1964909
8;;N;DEL;43243912;43251899;CNV;7987
8;;N;DUP;43252633;139222645;CNV;95970012
8;;N;DUP;139288422;142824280;CNV;3535858
9;;N;DEL;249391;137995921;CNV;137746530
10;;N;DUP;64877396;65289510;CNV;412114
11;;N;DEL;60294059;75498353;CNV;15204294
11;;N;DEL;86638537;86865130;CNV;226593
11;;N;DUP;97318426;98358533;CNV;1040107
13;;N;DUP;30990293;33048558;CNV;2058265
13;;N;DUP;33080871;38008041;CNV;4927170
16;;N;DEL;215160;22786531;CNV;22571371
17;;N;DEL;601219;19796045;CNV;19194826
20;;N;DUP;15923065;16269101;CNV;346036
20;;N;DUP;31258500;44466857;CNV;13208357
20;;N;DUP;44551974;61505375;CNV;16953401
20;;N;DUP;61569562;64240906;CNV;2671344
21;;N;DEL;23870811;24321318;CNV;450507
21;;N;DEL;33698136;36914674;CNV;3216538
22;;N;DEL;37431160;42951180;CNV;5520020
8;;N;DUP;3958599;6094820;CNV;2136221
8;;N;DEL;136777136;136778556;CNV;1420
10;;N;DEL;108387111;110826038;CNV;2438927
18;;N;DEL;47425860;47871252;CNV;445392
21;;N;DEL;18766626;18841604;CNV;74978
1;;N;DEL;911484;26208655;CNV;25297171
1;;N;DEL;68826786;74845673;CNV;6018887
1;;N;DEL;79062825;83771215;CNV;4708390
1;;N;DEL;88228266;88410766;CNV;182500
1;;N;DUP;200602923;208424636;CNV;7821713
1;;N;DUP;221785656;226995658;CNV;5210002
1;;N;DUP;227615350;236131803;CNV;8516453
3;;N;DEL;35086277;36408887;CNV;1322610
3;;N;DUP;46496260;51372633;CNV;4876373
5;;N;DEL;18435576;30164369;CNV;11728793
6;;N;DUP;205610;30044157;CNV;29838547
6;;N;DUP;30058207;38242743;CNV;8184536
6;;N;DUP;38242799;47755941;CNV;9513142
6;;N;DUP;129670636;170543473;CNV;40872837
7;;N;DUP;1494152;8203410;CNV;6709258
7;;N;DUP;21735458;48389832;CNV;26654374
7;;N;DUP;148588790;159262480;CNV;10673690
8;;N;DEL;277598;2196998;CNV;1919400
8;;N;DEL;2214638;5963363;CNV;3748725
8;;N;DEL;5964877;13556645;CNV;7591768
8;;N;DEL;13556771;16682730;CNV;3125959
8;;N;DEL;16684327;31592253;CNV;14907926
8;;N;DUP;65711997;142824280;CNV;77112283
10;;N;DEL;2309651;2403369;CNV;93718
10;;N;DEL;80984052;83539475;CNV;2555423
11;;N;DUP;64434456;68564247;CNV;4129791
12;;N;DEL;22536670;24708242;CNV;2171572
15;;N;DEL;34861661;37948114;CNV;3086453
16;;N;DUP;215160;4868364;CNV;4653204
17;;N;DUP;18509845;19796045;CNV;1286200
17;;N;DEL;33922270;37666305;CNV;3744035
17;;N;DUP;47795563;48183312;CNV;387749
17;;N;DUP;48245242;50196930;CNV;1951688
17;;N;DEL;51142086;53120224;CNV;1978138
17;;N;DEL;53126477;56501559;CNV;3375082
17;;N;DEL;56535084;57140362;CNV;605278
17;;N;DEL;59360804;62100143;CNV;2739339
17;;N;DUP;63364102;65283680;CNV;1919578
17;;N;DUP;66933497;68757445;CNV;1823948
17;;N;DEL;69927937;72466705;CNV;2538768
19;;N;DUP;390341;20986748;CNV;20596407
19;;N;DUP;41062282;58234565;CNV;17172283
20;;N;DUP;24140467;24401677;CNV;261210
20;;N;DUP;24417504;64240906;CNV;39823402
21;;N;DEL;10494342;30854486;CNV;20360144
22;;N;DEL;23365833;50242600;CNV;26876767
4;;N;DEL;415163;189795030;CNV;189379867
8;;N;DEL;240568;30604632;CNV;30364064
8;;N;DUP;30750071;32685712;CNV;1935641
8;;N;DEL;32773255;37021821;CNV;4248566
8;;N;DUP;37022357;142824280;CNV;105801923
12;;N;DUP;25626182;25883047;CNV;256865
13;;N;DUP;25775933;53178046;CNV;27402113
13;;N;DUP;53178205;69790192;CNV;16611987
13;;N;DUP;69854018;108240073;CNV;38386055
14;;N;DUP;78128312;78228474;CNV;100162
14;;N;DUP;85154155;85602283;CNV;448128
16;;N;DUP;51171908;51467515;CNV;295607
16;;N;DEL;79646516;79646955;CNV;439
17;;N;DUP;27132035;82630699;CNV;55498664
21;;N;DUP;13656214;14852487;CNV;1196273
21;;N;DUP;14855657;16053858;CNV;1198201
21;;N;DEL;16192155;18829457;CNV;2637302
21;;N;DEL;18839710;18842097;CNV;2387
21;;N;DEL;18842824;25510394;CNV;6667570
21;;N;DUP;25547104;25664879;CNV;117775
21;;N;DEL;25763251;32270990;CNV;6507739
21;;N;DUP;32271545;34466976;CNV;2195431
21;;N;DEL;34545782;46680243;CNV;12134461
3;;N;DEL;85534043;85566831;CNV;32788
7;;N;DEL;124812907;124822027;CNV;9120
8;;N;DEL;240568;2215736;CNV;1975168
8;;N;DEL;6936018;9876554;CNV;2940536
8;;N;DEL;139596516;142824280;CNV;3227764
9;;N;DUP;2528774;3134377;CNV;605603
10;;N;DEL;79892150;84704831;CNV;4812681
10;;N;DEL;85455703;104980646;CNV;19524943
11;;N;DEL;98369889;110234356;CNV;11864467
15;;N;DUP;20743076;22869665;CNV;2126589
20;;N;DEL;57457470;57864601;CNV;407131
22;;N;DEL;37431160;43733095;CNV;6301935
8;;N;DUP;74327743;139222645;CNV;64894902
9;;N;DUP;11606029;11609017;CNV;2988
19;;N;DEL;45283788;58234565;CNV;12950777
1;;N;DEL;234848836;235749859;CNV;901023
1;;N;DEL;236132716;236133060;CNV;344
4;;N;DEL;415163;33723783;CNV;33308620
5;;N;DEL;111137888;111574957;CNV;437069
6;;N;DEL;102385980;124857222;CNV;22471242
8;;N;DEL;240568;41667290;CNV;41426722
8;;N;DUP;41826106;139296354;CNV;97470248
12;;N;DEL;9378459;9512053;CNV;133594
13;;N;DUP;18848939;97240061;CNV;78391122
13;;N;DEL;97276900;97302171;CNV;25271
13;;N;DUP;97326805;114267888;CNV;16941083
17;;N;DEL;38765943;47908048;CNV;9142105
17;;N;DEL;56822584;62335640;CNV;5513056
17;;N;DEL;71835902;82630699;CNV;10794797
18;;N;DEL;159885;68444943;CNV;68285058
18;;N;DEL;71827674;75792434;CNV;3964760
18;;N;DUP;75796845;75977771;CNV;180926
20;;N;DUP;31418506;55713940;CNV;24295434
20;;N;DUP;55715650;55956718;CNV;241068
20;;N;DUP;55960359;60894071;CNV;4933712
5;;N;DEL;24922486;24922680;CNV;194
6;;N;DUP;133280124;135193420;CNV;1913296
8;;N;DEL;5934861;6096213;CNV;161352
15;;N;DEL;92995200;92995421;CNV;221
7;;N;DEL;55981326;67594477;CNV;11613151
8;;N;DUP;100282771;136755501;CNV;36472730
12;;N;DUP;24794581;26337222;CNV;1542641
14;;N;DEL;79525769;98224057;CNV;18698288
14;;N;DEL;98922042;106832764;CNV;7910722
18;;N;DEL;48458820;54471441;CNV;6012621
18;;N;DUP;75792434;75977771;CNV;185337
22;;N;DEL;40474790;43614264;CNV;3139474
1;;N;DEL;911484;36412423;CNV;35500939
5;;N;DEL;52577996;52726879;CNV;148883
6;;N;DUP;205610;14445508;CNV;14239898
6;;N;DUP;40593966;66358127;CNV;25764161
6;;N;DUP;66418947;66502734;CNV;83787
6;;N;DEL;66503711;170279302;CNV;103775591
7;;N;DUP;1494152;15144073;CNV;13649921
8;;N;DEL;6095094;40192491;CNV;34097397
8;;N;DUP;40227637;77594926;CNV;37367289
8;;N;DUP;77639466;142824280;CNV;65184814
9;;N;DUP;249391;61201216;CNV;60951825
9;;N;DUP;99000809;125766699;CNV;26765890
20;;N;DUP;167044;15243016;CNV;15075972
20;;N;DUP;15923065;16271023;CNV;347958
20;;N;DUP;17562692;64240906;CNV;46678214
1;;N;DEL;911484;113568414;CNV;112656930
1;;N;DUP;113612787;117423539;CNV;3810752
2;;N;DUP;110819;41414740;CNV;41303921
2;;N;DUP;230558408;240942225;CNV;10383817
3;;N;DEL;60052274;60632434;CNV;580160
3;;N;DUP;169531688;170203653;CNV;671965
3;;N;DUP;173422892;173792737;CNV;369845
3;;N;DUP;175156885;177688276;CNV;2531391
3;;N;DUP;178638449;190788694;CNV;12150245
3;;N;DUP;190803931;197336437;CNV;6532506
4;;N;DEL;54502821;86255292;CNV;31752471
4;;N;DEL;89350969;189795030;CNV;100444061
5;;N;DUP;25608207;32517226;CNV;6909019
8;;N;DEL;277598;4715320;CNV;4437722
8;;N;DEL;4716817;6377962;CNV;1661145
8;;N;DEL;6378006;43252633;CNV;36874627
8;;N;DUP;43300036;48861025;CNV;5560989
8;;N;DUP;49286249;49376463;CNV;90214
8;;N;DUP;49474062;51025351;CNV;1551289
8;;N;DUP;51058577;74910616;CNV;23852039
8;;N;DUP;75028709;75889295;CNV;860586
8;;N;DUP;75985310;76626846;CNV;641536
8;;N;DEL;76731232;77410832;CNV;679600
8;;N;DUP;77547390;80134140;CNV;2586750
8;;N;DEL;87157469;89214197;CNV;2056728
8;;N;DUP;116163109;119345184;CNV;3182075
8;;N;DUP;119371790;119802542;CNV;430752
8;;N;DUP;119839860;136755501;CNV;16915641
8;;N;DEL;136776958;137494691;CNV;717733
8;;N;DUP;137504384;142824280;CNV;5319896
9;;N;DEL;478153;3866063;CNV;3387910
9;;N;DUP;3867540;4084134;CNV;216594
9;;N;DEL;4104571;7895438;CNV;3790867
9;;N;DEL;7915577;12150471;CNV;4234894
9;;N;DUP;12204748;15141251;CNV;2936503
9;;N;DUP;15272464;17524040;CNV;2251576
9;;N;DUP;17658341;17948529;CNV;290188
9;;N;DUP;17989792;18530257;CNV;540465
9;;N;DUP;18651933;18758838;CNV;106905
9;;N;DUP;18790085;19052925;CNV;262840
9;;N;DUP;32574339;75981193;CNV;43406854
9;;N;DUP;76070954;76810776;CNV;739822
9;;N;DUP;76852288;115935122;CNV;39082834
9;;N;DUP;119657117;137995921;CNV;18338804
10;;N;DEL;223755;25233351;CNV;25009596
10;;N;DUP;25345610;51081015;CNV;25735405
10;;N;DUP;54572210;85002634;CNV;30430424
10;;N;DEL;90674787;100946841;CNV;10272054
10;;N;DEL;105724673;109180112;CNV;3455439
10;;N;DEL;113707549;126718243;CNV;13010694
13;;N;DUP;18848939;77410534;CNV;58561595
13;;N;DUP;79630365;83011241;CNV;3380876
16;;N;DUP;215160;2757262;CNV;2542102
16;;N;DEL;6264861;7019055;CNV;754194
16;;N;DEL;61597418;82987224;CNV;21389806
17;;N;DEL;10320967;12501738;CNV;2180771
17;;N;DUP;39283243;40132808;CNV;849565
17;;N;DUP;40663989;41285737;CNV;621748
17;;N;DEL;56047631;74652981;CNV;18605350
20;;N;DUP;167044;14495402;CNV;14328358
20;;N;DEL;14495629;15112218;CNV;616589
20;;N;DUP;17810419;25525946;CNV;7715527
20;;N;DUP;31418506;64240906;CNV;32822400
21;;N;DEL;10494342;25357257;CNV;14862915
21;;N;DEL;26506258;30815413;CNV;4309155
8;;N;DEL;240568;3705005;CNV;3464437
8;;N;DEL;3722560;6018538;CNV;2295978
8;;N;DEL;6023894;37481605;CNV;31457711
8;;N;DUP;37496263;82138348;CNV;44642085
8;;N;DUP;88255953;105339770;CNV;17083817
8;;N;DUP;105348445;113995166;CNV;8646721
8;;N;DUP;114014973;117021881;CNV;3006908
8;;N;DUP;130812051;139296354;CNV;8484303
16;;N;DUP;77349883;77925795;CNV;575912
18;;N;DEL;159885;1757846;CNV;1597961
18;;N;DEL;1765639;7467034;CNV;5701395
18;;N;DEL;53937752;60759099;CNV;6821347
18;;N;DEL;60769518;69957318;CNV;9187800
18;;N;DEL;70024284;75776421;CNV;5752137
18;;N;DUP;75792434;75946981;CNV;154547
20;;N;DEL;15670252;15671242;CNV;990
20;;N;DUP;16038607;19007451;CNV;2968844
20;;N;DUP;19012470;43049711;CNV;24037241
20;;N;DUP;43078361;64240906;CNV;21162545
8;;N;DEL;139508977;142824280;CNV;3315303
13;;N;DUP;26625285;26716849;CNV;91564
13;;N;DUP;27393704;27957248;CNV;563544
13;;N;DUP;43608498;44040903;CNV;432405
13;;N;DUP;108803418;110927204;CNV;2123786
15;;N;DEL;50138025;50140297;CNV;2272
17;;N;DEL;74527085;74652981;CNV;125896
8;;N;DEL;866716;2215736;CNV;1349020
8;;N;DEL;3790798;5963363;CNV;2172565
8;;N;DEL;240568;40476976;CNV;40236408
8;;N;DUP;40477467;82698146;CNV;42220679
8;;N;DUP;82775726;83126085;CNV;350359
8;;N;DUP;83188891;142824280;CNV;59635389
13;;N;DUP;18848939;24126477;CNV;5277538
13;;N;DUP;29369100;31232835;CNV;1863735
13;;N;DUP;33807613;44163933;CNV;10356320
13;;N;DUP;44180935;47647608;CNV;3466673
13;;N;DUP;53032380;62372600;CNV;9340220
13;;N;DUP;71375401;79195468;CNV;7820067
13;;N;DUP;89281287;90115362;CNV;834075
13;;N;DUP;107065631;114267888;CNV;7202257
17;;N;DEL;9209786;16932739;CNV;7722953
20;;N;DUP;31354892;64240906;CNV;32886014
1;;N;DEL;187778656;188584790;CNV;806134
3;;N;DEL;2680636;2682331;CNV;1695
4;;N;DEL;415163;9606465;CNV;9191302
4;;N;DEL;9812832;34983219;CNV;25170387
4;;N;DEL;35098385;56927585;CNV;21829200
4;;N;DEL;56958974;189795030;CNV;132836056
5;;N;DEL;10733664;19493575;CNV;8759911
6;;N;DUP;205610;18767626;CNV;18562016
6;;N;DUP;166160056;170543473;CNV;4383417
10;;N;DUP;223755;38255991;CNV;38032236
11;;N;DEL;54745406;60417861;CNV;5672455
11;;N;DEL;60543650;78225120;CNV;17681470
11;;N;DEL;78230030;133925122;CNV;55695092
12;;N;DUP;114256;9777083;CNV;9662827
12;;N;DUP;125400758;132924025;CNV;7523267
13;;N;DUP;18848939;25189017;CNV;6340078
13;;N;DUP;25384277;31232835;CNV;5848558
13;;N;DUP;31318893;42030804;CNV;10711911
13;;N;DUP;42062807;42160430;CNV;97623
13;;N;DUP;42161262;43082681;CNV;921419
16;;N;DUP;215160;4868325;CNV;4653165
16;;N;DUP;83421727;89774300;CNV;6352573
19;;N;DUP;390341;16223187;CNV;15832846
19;;N;DUP;16241592;16501200;CNV;259608
20;;N;DUP;14749223;18189653;CNV;3440430
20;;N;DUP;31430739;64240906;CNV;32810167
1;;N;DEL;911484;23306060;CNV;22394576
1;;N;DEL;23326934;24009753;CNV;682819
1;;N;DEL;24010034;36412423;CNV;12402389
2;;N;DUP;109623995;114508979;CNV;4884984
2;;N;DUP;137699791;137751562;CNV;51771
5;;N;DEL;26046533;28570278;CNV;2523745
5;;N;DEL;53429721;92636363;CNV;39206642
5;;N;DEL;115900993;115901069;CNV;76
5;;N;DEL;128833547;136041660;CNV;7208113
6;;N;DEL;78047786;78990321;CNV;942535
6;;N;DEL;82900346;89329237;CNV;6428891
6;;N;DEL;89329951;90927971;CNV;1598020
6;;N;DEL;93492888;93493468;CNV;580
6;;N;DEL;101917263;102819005;CNV;901742
6;;N;DUP;106680131;107780800;CNV;1100669
6;;N;DEL;107851023;112455209;CNV;4604186
8;;N;DEL;277598;4651181;CNV;4373583
8;;N;DEL;4668827;5960606;CNV;1291779
8;;N;DEL;5963363;33800500;CNV;27837137
8;;N;DUP;33809635;38806656;CNV;4997021
8;;N;DUP;41658474;78660874;CNV;37002400
8;;N;DEL;78662938;78663924;CNV;986
8;;N;DUP;78709474;89628493;CNV;10919019
8;;N;DUP;89658452;139360787;CNV;49702335
8;;N;DUP;139457551;142824280;CNV;3366729
11;;N;DUP;73649245;134707739;CNV;61058494
13;;N;DUP;25189017;41463799;CNV;16274782
13;;N;DUP;41467803;43608498;CNV;2140695
13;;N;DUP;43665421;52771081;CNV;9105660
13;;N;DUP;52787160;69245804;CNV;16458644
13;;N;DUP;69246320;102493400;CNV;33247080
13;;N;DUP;102849670;103107400;CNV;257730
13;;N;DUP;103585618;106584166;CNV;2998548
13;;N;DUP;106649072;114267888;CNV;7618816
14;;N;DUP;19747289;55758517;CNV;36011228
14;;N;DEL;78338968;85559084;CNV;7220116
14;;N;DUP;85561181;85602283;CNV;41102
14;;N;DEL;85610666;87392862;CNV;1782196
15;;N;DUP;20743076;23779258;CNV;3036182
15;;N;DUP;38651851;40226807;CNV;1574956
15;;N;DEL;40325213;80100717;CNV;39775504
16;;N;DUP;215160;4170263;CNV;3955103
17;;N;DUP;27085689;36062058;CNV;8976369
17;;N;DUP;36631986;43738398;CNV;7106412
17;;N;DEL;59740336;60090961;CNV;350625
17;;N;DUP;81182751;82630699;CNV;1447948
20;;N;DEL;167044;14211181;CNV;14044137
20;;N;DUP;14300436;15444809;CNV;1144373
20;;N;DUP;15923065;16423435;CNV;500370
20;;N;DEL;24401677;31316342;CNV;6914665
20;;N;DUP;31354892;43049711;CNV;11694819
20;;N;DUP;43078361;52541309;CNV;9462948
20;;N;DUP;52662565;54639706;CNV;1977141
20;;N;DUP;54703182;55298695;CNV;595513
20;;N;DEL;55343482;55582947;CNV;239465
20;;N;DUP;55614116;64240906;CNV;8626790
1;;N;DEL;14716521;34109240;CNV;19392719
1;;N;DUP;34117031;34805056;CNV;688025
1;;N;DUP;34805126;35648632;CNV;843506
1;;N;DUP;36412423;41038770;CNV;4626347
1;;N;DEL;41041759;41042818;CNV;1059
1;;N;DEL;54801836;64222952;CNV;9421116
1;;N;DEL;69815363;74333584;CNV;4518221
1;;N;DEL;80371196;85452418;CNV;5081222
1;;N;DEL;196633195;196726612;CNV;93417
2;;N;DUP;49408096;63952101;CNV;14544005
5;;N;DEL;100735755;103284973;CNV;2549218
5;;N;DEL;103672721;106462609;CNV;2789888
5;;N;DEL;106636447;110716798;CNV;4080351
5;;N;DEL;110754002;120251119;CNV;9497117
8;;N;DEL;240568;35729905;CNV;35489337
8;;N;DEL;35838032;35838293;CNV;261
11;;N;DEL;110810251;134707739;CNV;23897488
12;;N;DEL;10093121;16971111;CNV;6877990
14;;N;DEL;19747289;27769255;CNV;8021966
15;;N;DEL;94549928;101824457;CNV;7274529
17;;N;DUP;1201426;4105526;CNV;2904100
17;;N;DEL;5900755;27160113;CNV;21259358
18;;N;DEL;1305893;6886548;CNV;5580655
18;;N;DEL;7465951;23547946;CNV;16081995
18;;N;DEL;23749613;29867798;CNV;6118185
18;;N;DEL;29880994;80087573;CNV;50206579
1;;N;DEL;119594822;119674791;CNV;79969
1;;N;DEL;227056783;227059315;CNV;2532
14;;N;DUP;78128312;78128331;CNV;19
1;;N;DEL;911484;42936158;CNV;42024674
1;;N;DEL;69193736;75252625;CNV;6058889
1;;N;DEL;80391276;80913553;CNV;522277
1;;N;DEL;185957447;199694313;CNV;13736866
1;;N;DUP;225855773;227040336;CNV;1184563
1;;N;DUP;234497322;234527486;CNV;30164
1;;N;DUP;234527887;236131525;CNV;1603638
2;;N;DEL;225354604;225703686;CNV;349082
3;;N;DEL;119131;2964760;CNV;2845629
3;;N;DEL;6465603;6658207;CNV;192604
3;;N;DUP;9378083;14768783;CNV;5390700
4;;N;DUP;415163;7059492;CNV;6644329
4;;N;DUP;7172344;8118939;CNV;946595
5;;N;DEL;18713443;30608400;CNV;11894957
5;;N;DEL;39900901;39901047;CNV;146
5;;N;DEL;41234541;41234906;CNV;365
6;;N;DEL;8564642;9983631;CNV;1418989
6;;N;DUP;14877829;15823966;CNV;946137
6;;N;DUP;131421100;132399484;CNV;978384
6;;N;DUP;133871632;134409117;CNV;537485
7;;N;DUP;3436912;20598098;CNV;17161186
7;;N;DUP;20701544;28451046;CNV;7749502
7;;N;DEL;28505257;28566658;CNV;61401
7;;N;DUP;28577012;38215738;CNV;9638726
7;;N;DUP;38239188;42432906;CNV;4193718
7;;N;DUP;42485084;45207385;CNV;2722301
7;;N;DUP;45523148;48469222;CNV;2946074
7;;N;DUP;48504615;80069738;CNV;31565123
7;;N;DUP;134441166;134644207;CNV;203041
7;;N;DUP;135078446;135842895;CNV;764449
7;;N;DUP;139131858;142720787;CNV;3588929
7;;N;DUP;142768189;144000599;CNV;1232410
7;;N;DUP;148766768;159262480;CNV;10495712
8;;N;DEL;3808576;5964877;CNV;2156301
8;;N;DEL;5968118;13557232;CNV;7589114
8;;N;DEL;13563809;17049616;CNV;3485807
8;;N;DEL;17049808;38806656;CNV;21756848
8;;N;DUP;39354936;70323732;CNV;30968796
8;;N;DUP;70328243;73309171;CNV;2980928
8;;N;DUP;73455706;142824280;CNV;69368574
9;;N;DUP;249391;8159670;CNV;7910279
9;;N;DUP;8245198;11990405;CNV;3745207
9;;N;DUP;12144878;117939171;CNV;105794293
9;;N;DUP;121189407;121431890;CNV;242483
9;;N;DUP;127385327;137995921;CNV;10610594
10;;N;DEL;61339792;64846182;CNV;3506390
10;;N;DEL;65028292;67428208;CNV;2399916
10;;N;DEL;81222137;83539475;CNV;2317338
10;;N;DEL;89185999;89186051;CNV;52
11;;N;DUP;1961088;4546105;CNV;2585017
11;;N;DUP;7308662;20661604;CNV;13352942
11;;N;DUP;22459887;35647339;CNV;13187452
12;;N;DUP;114256;4384628;CNV;4270372
12;;N;DUP;30115471;33163183;CNV;3047712
12;;N;DEL;33245799;43375915;CNV;10130116
12;;N;DEL;82961773;91414672;CNV;8452899
12;;N;DEL;95873520;97296412;CNV;1422892
12;;N;DEL;98802020;101342603;CNV;2540583
13;;N;DUP;31318893;40015928;CNV;8697035
13;;N;DUP;40057973;53178046;CNV;13120073
13;;N;DUP;70083264;85698523;CNV;15615259
13;;N;DUP;94989232;100824914;CNV;5835682
13;;N;DUP;100827105;109071912;CNV;8244807
14;;N;DEL;19747289;20056096;CNV;308807
14;;N;DUP;87401929;87543280;CNV;141351
15;;N;DUP;20743076;22832212;CNV;2089136
15;;N;DUP;22734626;31032328;CNV;8297702
15;;N;DUP;32748395;35947845;CNV;3199450
15;;N;DUP;36565184;38257841;CNV;1692657
15;;N;DUP;38288041;45837944;CNV;7549903
15;;N;DUP;72721435;101824457;CNV;29103022
18;;N;DEL;1570336;1690050;CNV;119714
18;;N;DEL;21527130;56199372;CNV;34672242
18;;N;DEL;56206065;59785871;CNV;3579806
18;;N;DEL;59807354;80087573;CNV;20280219
19;;N;DUP;20315194;39813794;CNV;19498600
19;;N;DEL;40031894;58234565;CNV;18202671
20;;N;DEL;167044;6128102;CNV;5961058
20;;N;DEL;6147554;17609975;CNV;11462421
20;;N;DEL;17810397;26227269;CNV;8416872
20;;N;DUP;31258500;54639706;CNV;23381206
20;;N;DUP;54703182;55582947;CNV;879765
21;;N;DEL;39799817;39878615;CNV;78798
21;;N;DEL;40143102;40441200;CNV;298098
1;;N;DEL;92628570;97613672;CNV;4985102
1;;N;DEL;98132896;99203395;CNV;1070499
1;;N;DUP;106801700;113190523;CNV;6388823
1;;N;DUP;119918293;248655165;CNV;128736872
4;;N;DEL;117828557;126154182;CNV;8325625
6;;N;DUP;205610;57012520;CNV;56806910
15;;N;DUP;20743076;29310799;CNV;8567723
15;;N;DEL;29574843;101824457;CNV;72249614
18;;N;DEL;159885;72137306;CNV;71977421
18;;N;DEL;72143832;72378884;CNV;235052
18;;N;DEL;72474085;80087573;CNV;7613488
1;;N;DUP;153490975;157501265;CNV;4010290
1;;N;DUP;157527473;162940179;CNV;5412706
1;;N;DUP;177617105;185755484;CNV;8138379
1;;N;DUP;185851620;200504351;CNV;14652731
1;;N;DUP;200594843;207462444;CNV;6867601
1;;N;DUP;207641844;227040336;CNV;19398492
1;;N;DUP;227212352;248655165;CNV;21442813
2;;N;DUP;60028411;66012144;CNV;5983733
2;;N;DEL;70657444;81465783;CNV;10808339
2;;N;DUP;81518137;81802279;CNV;284142
2;;N;DEL;81811569;84244986;CNV;2433417
2;;N;DUP;84258897;102668157;CNV;18409260
2;;N;DUP;167827180;195029073;CNV;27201893
2;;N;DEL;195029354;195109336;CNV;79982
2;;N;DUP;195109639;201630757;CNV;6521118
2;;N;DEL;212982786;214587893;CNV;1605107
3;;N;DUP;121645326;126167598;CNV;4522272
4;;N;DUP;415163;3217599;CNV;2802436
4;;N;DUP;3267165;8462802;CNV;5195637
4;;N;DEL;12178853;12179167;CNV;314
4;;N;DUP;12180598;31094056;CNV;18913458
4;;N;DEL;43279223;46923796;CNV;3644573
4;;N;DEL;59538762;125255455;CNV;65716693
4;;N;DEL;125365159;137239398;CNV;11874239
4;;N;DEL;137315158;189795030;CNV;52479872
5;;N;DUP;207389;21551434;CNV;21344045
5;;N;DUP;21631495;26514611;CNV;4883116
5;;N;DUP;26527900;30608400;CNV;4080500
5;;N;DUP;30723380;36191650;CNV;5468270
5;;N;DUP;36212115;41751600;CNV;5539485
5;;N;DUP;41815790;45553285;CNV;3737495
5;;N;DUP;45739965;51232355;CNV;5492390
6;;N;DUP;205610;61702727;CNV;61497117
6;;N;DEL;61703641;77608133;CNV;15904492
6;;N;DEL;83531437;92525020;CNV;8993583
6;;N;DEL;92566963;125316237;CNV;32749274
6;;N;DEL;162150291;166148609;CNV;3998318
6;;N;DEL;166160056;170543473;CNV;4383417
7;;N;DUP;1494152;3491977;CNV;1997825
7;;N;DUP;3651647;16620348;CNV;12968701
7;;N;DUP;16755939;55981326;CNV;39225387
7;;N;DUP;56119414;82555661;CNV;26436247
7;;N;DEL;88443580;127225983;CNV;38782403
7;;N;DEL;144023894;148728823;CNV;4704929
8;;N;DEL;3811129;4065174;CNV;254045
8;;N;DEL;4099442;4644964;CNV;545522
8;;N;DEL;4650042;5968989;CNV;1318947
8;;N;DEL;6017973;36156306;CNV;30138333
8;;N;DUP;39973181;51083515;CNV;11110334
8;;N;DUP;57976915;69694927;CNV;11718012
8;;N;DUP;70034358;78660874;CNV;8626516
8;;N;DEL;78662938;78709474;CNV;46536
8;;N;DUP;78729671;93377336;CNV;14647665
8;;N;DUP;93383784;142824280;CNV;49440496
9;;N;DEL;8177428;8268198;CNV;90770
9;;N;DUP;8332353;9882403;CNV;1550050
9;;N;DUP;9885311;14841635;CNV;4956324
9;;N;DUP;14858085;17304103;CNV;2446018
9;;N;DUP;17304245;23761276;CNV;6457031
9;;N;DUP;24006000;27151647;CNV;3145647
9;;N;DUP;27152104;27428667;CNV;276563
9;;N;DUP;27447091;32516951;CNV;5069860
9;;N;DUP;32574339;63671869;CNV;31097530
9;;N;DUP;127446097;137995921;CNV;10549824
10;;N;DEL;49760749;55874655;CNV;6113906
10;;N;DEL;56007409;67428208;CNV;11420799
10;;N;DEL;81374678;83442681;CNV;2068003
10;;N;DEL;83453609;93637493;CNV;10183884
10;;N;DEL;93679616;93699510;CNV;19894
10;;N;DEL;93699941;121902207;CNV;28202266
10;;N;DEL;122103437;122426851;CNV;323414
12;;N;DUP;114256;16710839;CNV;16596583
13;;N;DUP;94989232;97240061;CNV;2250829
13;;N;DUP;97326805;100827105;CNV;3500300
13;;N;DEL;103174933;103195603;CNV;20670
14;;N;DUP;72521938;78330154;CNV;5808216
15;;N;DUP;20743076;22856510;CNV;2113434
15;;N;DEL;35535414;36577606;CNV;1042192
16;;N;DUP;215160;12526972;CNV;12311812
16;;N;DUP;13802376;46702351;CNV;32899975
16;;N;DUP;47112807;49294518;CNV;2181711
16;;N;DUP;57074909;58165766;CNV;1090857
16;;N;DEL;59374438;62317300;CNV;2942862
17;;N;DEL;10320967;16631280;CNV;6310313
17;;N;DUP;16932739;51636860;CNV;34704121
17;;N;DUP;74778036;82630699;CNV;7852663
18;;N;DEL;59785871;76481557;CNV;16695686
18;;N;DEL;76481807;80087573;CNV;3605766
19;;N;DUP;27898221;58234565;CNV;30336344
20;;N;DUP;31354892;35017295;CNV;3662403
20;;N;DUP;35065161;47044945;CNV;11979784
20;;N;DUP;47604780;55212793;CNV;7608013
21;;N;DEL;18840374;18841604;CNV;1230
21;;N;DUP;30854486;46680243;CNV;15825757
22;;N;DUP;22129518;22152664;CNV;23146
22;;N;DUP;35530340;37431160;CNV;1900820
8;;N;DUP;240568;471777;CNV;231209
8;;N;DUP;37480306;40227637;CNV;2747331
16;;N;DUP;24553938;28188558;CNV;3634620
17;;N;DUP;15776287;32622814;CNV;16846527
17;;N;DUP;72966033;82630699;CNV;9664666
1;;N;DEL;216573870;227997156;CNV;11423286
1;;N;DEL;228090807;237752848;CNV;9662041
1;;N;DEL;237759943;241268751;CNV;3508808
1;;N;DEL;241782992;248655165;CNV;6872173
2;;N;DEL;179739843;202674343;CNV;22934500
3;;N;DUP;11596043;13055557;CNV;1459514
3;;N;DEL;59920235;60330687;CNV;410452
3;;N;DEL;60335841;60577899;CNV;242058
4;;N;DUP;415163;9606465;CNV;9191302
7;;N;DUP;1494152;3454490;CNV;1960338
7;;N;DUP;3454739;150066677;CNV;146611938
7;;N;DUP;150250995;159262480;CNV;9011485
9;;N;DUP;124730219;137995921;CNV;13265702
10;;N;DEL;49085522;58091973;CNV;9006451
10;;N;DEL;61339841;64829405;CNV;3489564
10;;N;DUP;64834908;65241739;CNV;406831
10;;N;DEL;65261262;67428208;CNV;2166946
10;;N;DEL;81374678;83489966;CNV;2115288
11;;N;DEL;20647894;20648425;CNV;531
11;;N;DUP;64434955;69989981;CNV;5555026
12;;N;DUP;114256;4349866;CNV;4235610
12;;N;DUP;4384628;30115471;CNV;25730843
12;;N;DUP;30115552;33163183;CNV;3047631
12;;N;DUP;33245799;103849443;CNV;70603644
12;;N;DUP;103850656;132924025;CNV;29073369
13;;N;DUP;18848939;28763105;CNV;9914166
13;;N;DUP;28798306;39009488;CNV;10211182
13;;N;DUP;39010236;53423205;CNV;14412969
13;;N;DUP;53429368;57122534;CNV;3693166
13;;N;DEL;57243735;57312305;CNV;68570
13;;N;DUP;57321832;69247067;CNV;11925235
13;;N;DUP;69323537;101882144;CNV;32558607
13;;N;DUP;101903122;114267888;CNV;12364766
14;;N;DUP;78228087;78228474;CNV;387
14;;N;DEL;78275947;88229366;CNV;9953419
16;;N;DEL;6689701;6690261;CNV;560
16;;N;DEL;6695598;7458956;CNV;763358
16;;N;DEL;51685736;51727688;CNV;41952
16;;N;DEL;59474234;65773440;CNV;6299206
16;;N;DUP;65806957;72141257;CNV;6334300
17;;N;DUP;27131847;36062058;CNV;8930211
17;;N;DUP;36631986;52226959;CNV;15594973
17;;N;DUP;52227199;54473516;CNV;2246317
17;;N;DUP;54567197;56033743;CNV;1466546
19;;N;DUP;390341;13474041;CNV;13083700
20;;N;DEL;14749223;15274043;CNV;524820
20;;N;DUP;15923065;16195558;CNV;272493
20;;N;DUP;16269101;31418506;CNV;15149405
20;;N;DUP;31430739;35017295;CNV;3586556
20;;N;DUP;35065161;55298695;CNV;20233534
20;;N;DEL;55343482;55472039;CNV;128557
20;;N;DUP;55572790;61825779;CNV;6252989
20;;N;DUP;61911442;64240906;CNV;2329464
22;;N;DUP;15438402;25236299;CNV;9797897
22;;N;DUP;25679039;27857237;CNV;2178198
22;;N;DUP;27868986;32372564;CNV;4503578
1;;N;DEL;46653246;69144171;CNV;22490925
1;;N;DEL;69193736;85905466;CNV;16711730
1;;N;DEL;85911345;107684508;CNV;21773163
1;;N;DUP;107715643;110631264;CNV;2915621
1;;N;DEL;110712446;116370856;CNV;5658410
1;;N;DUP;116498164;118735228;CNV;2237064
1;;N;DUP;153822221;157501265;CNV;3679044
1;;N;DUP;178468309;179542519;CNV;1074210
1;;N;DUP;199758875;206902292;CNV;7143417
1;;N;DUP;211699848;214721264;CNV;3021416
1;;N;DEL;214721343;227997156;CNV;13275813
1;;N;DEL;237268205;248655165;CNV;11386960
3;;N;DEL;119131;3978406;CNV;3859275
3;;N;DEL;5359806;5774668;CNV;414862
3;;N;DUP;5786793;5848366;CNV;61573
3;;N;DEL;5859356;6421311;CNV;561955
3;;N;DUP;6453795;6465603;CNV;11808
3;;N;DEL;6491675;6715180;CNV;223505
3;;N;DEL;6729065;9341059;CNV;2611994
3;;N;DUP;9378083;14670535;CNV;5292452
3;;N;DEL;14705493;36638607;CNV;21933114
3;;N;DUP;193874888;197336437;CNV;3461549
4;;N;DEL;9812832;189795030;CNV;179982198
5;;N;DUP;207389;2223845;CNV;2016456
5;;N;DUP;79010752;79753666;CNV;742914
5;;N;DEL;101471764;107483705;CNV;6011941
6;;N;DUP;133871632;137392552;CNV;3520920
6;;N;DUP;148115732;150932246;CNV;2816514
7;;N;DUP;3436912;127056760;CNV;123619848
7;;N;DUP;127057596;129880743;CNV;2823147
7;;N;DUP;129896863;150250995;CNV;20354132
7;;N;DUP;150440780;154377012;CNV;3936232
7;;N;DEL;154398645;154399115;CNV;470
7;;N;DUP;154404016;159262480;CNV;4858464
8;;N;DEL;3790798;6139180;CNV;2348382
8;;N;DUP;93078993;119184776;CNV;26105783
8;;N;DUP;119957445;135995285;CNV;16037840
9;;N;DUP;249391;461505;CNV;212114
13;;N;DUP;18848939;30995219;CNV;12146280
13;;N;DUP;31011791;39009488;CNV;7997697
13;;N;DUP;53429368;69247067;CNV;15817699
13;;N;DUP;69323537;114267888;CNV;44944351
14;;N;DEL;19747289;36596980;CNV;16849691
14;;N;DEL;36605315;48850224;CNV;12244909
14;;N;DEL;48865531;63275781;CNV;14410250
14;;N;DEL;69304222;72521938;CNV;3217716
14;;N;DEL;78343131;88249028;CNV;9905897
14;;N;DEL;95225879;98099702;CNV;2873823
15;;N;DEL;20743076;35722935;CNV;14979859
15;;N;DEL;35766954;36540540;CNV;773586
15;;N;DEL;36565184;38757715;CNV;2192531
15;;N;DEL;45844625;49994784;CNV;4150159
15;;N;DEL;52951073;57173577;CNV;4222504
15;;N;DEL;57229954;93378109;CNV;36148155
15;;N;DEL;93387642;101824457;CNV;8436815
16;;N;DUP;4503191;56175169;CNV;51671978
16;;N;DUP;56212402;59374438;CNV;3162036
16;;N;DUP;65806957;69870235;CNV;4063278
16;;N;DUP;70494321;84088601;CNV;13594280
16;;N;DUP;84142165;84319977;CNV;177812
16;;N;DUP;85803416;89774300;CNV;3970884
17;;N;DEL;10320967;16005458;CNV;5684491
17;;N;DUP;59360804;68838531;CNV;9477727
17;;N;DUP;74703694;82630699;CNV;7927005
18;;N;DEL;159885;56350549;CNV;56190664
18;;N;DEL;60191569;80087573;CNV;19896004
19;;N;DUP;390341;16501200;CNV;16110859
20;;N;DUP;167044;6128102;CNV;5961058
20;;N;DUP;6147554;17409232;CNV;11261678
20;;N;DUP;17559507;18358849;CNV;799342
20;;N;DUP;18380991;26159564;CNV;7778573
20;;N;DEL;26219007;26227269;CNV;8262
20;;N;DUP;31258500;55212793;CNV;23954293
20;;N;DUP;55614116;61825779;CNV;6211663
12;;N;DEL;9511756;9777083;CNV;265327
15;;N;DEL;35394066;37948114;CNV;2554048
18;;N;DEL;68291311;68292110;CNV;799
20;;N;DUP;39388459;64240906;CNV;24852447
1;;N;DUP;911484;23045428;CNV;22133944
5;;N;DEL;22710728;30085953;CNV;7375225
5;;N;DEL;112064409;113963296;CNV;1898887
6;;N;DEL;119471384;120833730;CNV;1362346
7;;N;DUP;1494152;62969063;CNV;61474911
7;;N;DUP;156175917;159262480;CNV;3086563
8;;N;DEL;240568;37022357;CNV;36781789
8;;N;DUP;40098293;49065865;CNV;8967572
8;;N;DUP;49065995;118142057;CNV;69076062
8;;N;DUP;118252193;135995285;CNV;17743092
8;;N;DUP;135999084;142824280;CNV;6825196
10;;N;DEL;223755;31187558;CNV;30963803
11;;N;DEL;42139004;44475621;CNV;2336617
11;;N;DUP;60279937;74986607;CNV;14706670
11;;N;DUP;93990437;94917069;CNV;926632
13;;N;DUP;18848939;61977454;CNV;43128515
13;;N;DEL;61983787;88672734;CNV;26688947
13;;N;DUP;88733569;114267888;CNV;25534319
15;;N;DUP;20743076;22868175;CNV;2125099
15;;N;DEL;22867864;34785081;CNV;11917217
15;;N;DEL;34797231;39104480;CNV;4307249
16;;N;DUP;22753262;50721798;CNV;27968536
17;;N;DEL;601219;20303332;CNV;19702113
20;;N;DUP;167044;45367826;CNV;45200782
20;;N;DUP;45501956;46832470;CNV;1330514
20;;N;DEL;46923536;47044945;CNV;121409
20;;N;DUP;47604780;64240906;CNV;16636126
21;;N;DEL;10494342;18296660;CNV;7802318
21;;N;DEL;18306343;28882752;CNV;10576409
21;;N;DEL;29034026;46680243;CNV;17646217
16;;N;DEL;51171908;51171914;CNV;6
16;;N;DEL;72748925;72749081;CNV;156
8;;N;DUP;51025351;52001092;CNV;975741
20;;N;DUP;15273829;64240906;CNV;48967077
1;;N;DEL;119557357;119674791;CNV;117434
1;;N;DEL;169101094;200888646;CNV;31787552
1;;N;DUP;200920591;207442593;CNV;6522002
1;;N;DEL;238487649;238532736;CNV;45087
1;;N;DUP;246165712;248655165;CNV;2489453
2;;N;DEL;3848775;4916875;CNV;1068100
2;;N;DUP;8297119;9491211;CNV;1194092
2;;N;DEL;21114985;43788458;CNV;22673473
2;;N;DUP;45683753;59833445;CNV;14149692
2;;N;DUP;59892609;73988850;CNV;14096241
2;;N;DUP;74359684;81763699;CNV;7404015
2;;N;DEL;211826980;214215372;CNV;2388392
2;;N;DEL;225405457;225408052;CNV;2595
2;;N;DUP;226738639;228268852;CNV;1530213
3;;N;DEL;1358735;1899238;CNV;540503
3;;N;DEL;15956342;24942445;CNV;8986103
3;;N;DUP;25217014;25217111;CNV;97
4;;N;DUP;415163;10186757;CNV;9771594
4;;N;DEL;10200950;182582458;CNV;172381508
5;;N;DEL;22710728;23280430;CNV;569702
6;;N;DUP;205610;22075033;CNV;21869423
6;;N;DUP;22117206;23580474;CNV;1463268
6;;N;DUP;23580523;40217155;CNV;16636632
6;;N;DUP;40256529;40358103;CNV;101574
6;;N;DUP;40443961;56927778;CNV;16483817
6;;N;DEL;63972357;124361860;CNV;60389503
7;;N;DUP;1494152;22154001;CNV;20659849
7;;N;DUP;22183647;28505257;CNV;6321610
7;;N;DUP;28746353;40520137;CNV;11773784
7;;N;DUP;40618681;68690325;CNV;28071644
7;;N;DUP;68694605;78467162;CNV;9772557
7;;N;DUP;148240040;157509797;CNV;9269757
7;;N;DUP;157529938;159262480;CNV;1732542
8;;N;DUP;240568;2215026;CNV;1974458
8;;N;DUP;8340709;9190594;CNV;849885
8;;N;DUP;117924563;135686664;CNV;17762101
9;;N;DEL;249391;119659757;CNV;119410366
10;;N;DEL;51232731;68176982;CNV;16944251
10;;N;DEL;80983851;83180980;CNV;2197129
11;;N;DUP;1961088;13296006;CNV;11334918
11;;N;DEL;13473217;16836682;CNV;3363465
11;;N;DEL;20647894;33621827;CNV;12973933
11;;N;DUP;33623912;34841108;CNV;1217196
11;;N;DEL;34849005;35076646;CNV;227641
11;;N;DUP;35088128;35290833;CNV;202705
11;;N;DEL;35338469;60232605;CNV;24894136
11;;N;DUP;60232827;74104894;CNV;13872067
11;;N;DUP;122633543;134707739;CNV;12074196
13;;N;DUP;18848939;24713076;CNV;5864137
13;;N;DUP;24854227;28319733;CNV;3465506
13;;N;DUP;28394506;31331504;CNV;2936998
13;;N;DUP;31332004;41907312;CNV;10575308
13;;N;DUP;41915365;53234857;CNV;11319492
13;;N;DUP;53371475;89812266;CNV;36440791
13;;N;DUP;89821719;107810871;CNV;17989152
13;;N;DUP;107820207;107995958;CNV;175751
13;;N;DUP;108088670;108680664;CNV;591994
13;;N;DUP;108728378;109238542;CNV;510164
13;;N;DUP;109412253;111997186;CNV;2584933
13;;N;DUP;112107968;114267888;CNV;2159920
14;;N;DEL;19747289;19952526;CNV;205237
14;;N;DEL;19999171;62483575;CNV;42484404
14;;N;DEL;62484238;62531384;CNV;47146
14;;N;DEL;62617712;62874078;CNV;256366
14;;N;DEL;62917116;78976686;CNV;16059570
14;;N;DEL;78976953;94903549;CNV;15926596
15;;N;DEL;34785081;37948114;CNV;3163033
15;;N;DEL;53024290;53721296;CNV;697006
16;;N;DEL;6113799;8349270;CNV;2235471
16;;N;DUP;28188558;51528619;CNV;23340061
16;;N;DUP;51533320;83730535;CNV;32197215
16;;N;DUP;83730599;89774300;CNV;6043701
17;;N;DEL;601219;15897100;CNV;15295881
17;;N;DUP;16005458;51780396;CNV;35774938
18;;N;DEL;159885;7851247;CNV;7691362
18;;N;DEL;22499360;63623023;CNV;41123663
18;;N;DEL;63706631;65704539;CNV;1997908
18;;N;DEL;67407878;73665125;CNV;6257247
18;;N;DEL;76041456;76103583;CNV;62127
18;;N;DEL;76163198;80087573;CNV;3924375
20;;N;DUP;167044;714250;CNV;547206
20;;N;DUP;762576;6251236;CNV;5488660
20;;N;DEL;6257494;8489234;CNV;2231740
20;;N;DUP;16011257;16046391;CNV;35134
20;;N;DEL;16986636;17559507;CNV;572871
20;;N;DUP;19360075;26227269;CNV;6867194
20;;N;DUP;31258500;33222046;CNV;1963546
20;;N;DUP;33930548;37676762;CNV;3746214
20;;N;DUP;37745733;42836502;CNV;5090769
20;;N;DUP;42836554;54366246;CNV;11529692
20;;N;DUP;54388448;55713940;CNV;1325492
20;;N;DUP;55715650;64240906;CNV;8525256
21;;N;DEL;10494342;30787962;CNV;20293620
22;;N;DUP;15438402;50242600;CNV;34804198
1;;N;DUP;38825577;40683974;CNV;1858397
1;;N;DUP;40710794;68379056;CNV;27668262
1;;N;DUP;83788868;87815334;CNV;4026466
1;;N;DEL;88195413;88410766;CNV;215353
1;;N;DUP;88410919;91996096;CNV;3585177
1;;N;DUP;94424862;94962495;CNV;537633
1;;N;DUP;101461927;101473107;CNV;11180
1;;N;DUP;108017831;110631264;CNV;2613433
1;;N;DUP;154821287;156645402;CNV;1824115
1;;N;DEL;158384990;158862580;CNV;477590
1;;N;DUP;227962115;231267033;CNV;3304918
1;;N;DUP;233587624;235957436;CNV;2369812
2;;N;DUP;8026388;11552480;CNV;3526092
2;;N;DUP;19129135;21028168;CNV;1899033
2;;N;DEL;49408453;52872268;CNV;3463815
2;;N;DEL;57048839;58404798;CNV;1355959
2;;N;DUP;63658146;65263525;CNV;1605379
2;;N;DUP;69717028;71314530;CNV;1597502
2;;N;DUP;108354895;114242364;CNV;5887469
2;;N;DUP;126356095;128837347;CNV;2481252
2;;N;DUP;158759252;160732035;CNV;1972783
2;;N;DUP;188985968;191519240;CNV;2533272
2;;N;DUP;199188473;206447191;CNV;7258718
2;;N;DEL;206486950;206873491;CNV;386541
2;;N;DUP;222276719;225329637;CNV;3052918
2;;N;DEL;225354604;225652521;CNV;297917
2;;N;DUP;225703686;226025653;CNV;321967
2;;N;DEL;226128597;226386558;CNV;257961
2;;N;DUP;226913729;228268852;CNV;1355123
2;;N;DUP;234009088;240942225;CNV;6933137
3;;N;DUP;4114502;5274937;CNV;1160435
3;;N;DUP;8415103;16030840;CNV;7615737
3;;N;DUP;122810188;130231423;CNV;7421235
3;;N;DUP;169542534;172639709;CNV;3097175
4;;N;DUP;415163;10123631;CNV;9708468
4;;N;DEL;18923325;37560661;CNV;18637336
4;;N;DEL;41997268;46270789;CNV;4273521
4;;N;DEL;46369816;58686710;CNV;12316894
4;;N;DEL;58733357;75882914;CNV;17149557
4;;N;DEL;77270171;91362540;CNV;14092369
4;;N;DEL;91362620;92588008;CNV;1225388
4;;N;DEL;92725350;125078508;CNV;32353158
4;;N;DEL;125146073;137338570;CNV;12192497
4;;N;DEL;137347410;151938672;CNV;14591262
4;;N;DEL;153732915;182582458;CNV;28849543
5;;N;DEL;207389;17892328;CNV;17684939
5;;N;DEL;17921963;31317387;CNV;13395424
5;;N;DEL;31317422;101281541;CNV;69964119
5;;N;DEL;101384934;129841156;CNV;28456222
5;;N;DEL;152413049;153861611;CNV;1448562
5;;N;DUP;158657486;167829666;CNV;9172180
5;;N;DUP;167834377;180644249;CNV;12809872
6;;N;DEL;63974253;66642646;CNV;2668393
6;;N;DUP;134432086;139745948;CNV;5313862
6;;N;DUP;149840425;150541086;CNV;700661
6;;N;DUP;157684859;160279409;CNV;2594550
6;;N;DEL;164559838;165251364;CNV;691526
7;;N;DUP;1494152;7977268;CNV;6483116
7;;N;DUP;20598098;47456016;CNV;26857918
7;;N;DEL;78686099;98159181;CNV;19473082
7;;N;DUP;98159452;118245683;CNV;20086231
7;;N;DUP;126578691;133034456;CNV;6455765
7;;N;DUP;137874944;144000599;CNV;6125655
8;;N;DEL;240568;2196998;CNV;1956430
8;;N;DEL;2214638;6055525;CNV;3840887
8;;N;DEL;6094820;6966369;CNV;871549
8;;N;DEL;9203557;16682730;CNV;7479173
8;;N;DEL;31945942;41379918;CNV;9433976
8;;N;DUP;41382428;74170903;CNV;32788475
8;;N;DUP;79699954;82112592;CNV;2412638
8;;N;DUP;93599392;103570117;CNV;9970725
8;;N;DUP;118142057;134880097;CNV;16738040
9;;N;DUP;249391;2121124;CNV;1871733
9;;N;DUP;2157097;2904794;CNV;747697
9;;N;DUP;3743938;8159670;CNV;4415732
9;;N;DUP;8189112;9014274;CNV;825162
9;;N;DEL;29475547;29569368;CNV;93821
9;;N;DEL;31983462;32121630;CNV;138168
9;;N;DUP;32516951;73267793;CNV;40750842
9;;N;DUP;76216499;76652956;CNV;436457
9;;N;DUP;76736350;78521625;CNV;1785275
9;;N;DUP;81106003;88913650;CNV;7807647
9;;N;DUP;88913836;100573226;CNV;11659390
9;;N;DUP;100639656;104921355;CNV;4281699
9;;N;DUP;104936331;108302521;CNV;3366190
9;;N;DUP;108907977;114796423;CNV;5888446
10;;N;DEL;8521883;9022992;CNV;501109
10;;N;DUP;9060649;9283457;CNV;222808
10;;N;DEL;9286688;10479963;CNV;1193275
10;;N;DEL;36309499;37518919;CNV;1209420
10;;N;DUP;78550879;79043121;CNV;492242
10;;N;DUP;79114212;81003449;CNV;1889237
10;;N;DEL;81222137;83453609;CNV;2231472
10;;N;DUP;126238714;128037729;CNV;1799015
10;;N;DEL;128106653;133526341;CNV;5419688
11;;N;DUP;1961088;8796033;CNV;6834945
11;;N;DUP;9357458;13296006;CNV;3938548
11;;N;DUP;13473217;16007548;CNV;2534331
11;;N;DEL;16038287;16420076;CNV;381789
11;;N;DUP;16421268;20661604;CNV;4240336
11;;N;DUP;31614934;37025809;CNV;5410875
11;;N;DUP;43803931;48036761;CNV;4232830
11;;N;DUP;56824969;58201214;CNV;1376245
11;;N;DEL;58273149;60626906;CNV;2353757
11;;N;DEL;78754093;107272411;CNV;28518318
11;;N;DEL;121249421;122122872;CNV;873451
12;;N;DUP;114256;17029186;CNV;16914930
12;;N;DUP;17053276;18889293;CNV;1836017
12;;N;DUP;18996895;21019119;CNV;2022224
12;;N;DUP;24318826;24795108;CNV;476282
12;;N;DUP;24821712;26459137;CNV;1637425
12;;N;DUP;26485024;28320302;CNV;1835278
12;;N;DUP;28384177;33693661;CNV;5309484
12;;N;DUP;61152122;62030068;CNV;877946
12;;N;DUP;62051508;70319519;CNV;8268011
12;;N;DEL;70319875;70324914;CNV;5039
12;;N;DUP;70356717;71562233;CNV;1205516
12;;N;DUP;71566753;71572036;CNV;5283
12;;N;DUP;71593180;71961399;CNV;368219
12;;N;DUP;71961651;74051827;CNV;2090176
12;;N;DEL;83496301;87801317;CNV;4305016
12;;N;DUP;106126734;114040306;CNV;7913572
12;;N;DUP;114780717;114979799;CNV;199082
12;;N;DUP;114990436;119781260;CNV;4790824
12;;N;DUP;119790899;124819458;CNV;5028559
13;;N;DEL;18848939;19128784;CNV;279845
13;;N;DEL;78377745;78413821;CNV;36076
14;;N;DUP;20181216;25053063;CNV;4871847
14;;N;DUP;30026513;33659819;CNV;3633306
14;;N;DEL;33679008;33726051;CNV;47043
14;;N;DUP;33726120;37788676;CNV;4062556
14;;N;DUP;49228389;54637780;CNV;5409391
14;;N;DUP;54638123;55623213;CNV;985090
14;;N;DUP;55637560;62360622;CNV;6723062
14;;N;DEL;62373517;62917116;CNV;543599
14;;N;DUP;63036147;79045057;CNV;16008910
14;;N;DEL;84580566;84659065;CNV;78499
14;;N;DUP;88228998;106832764;CNV;18603766
15;;N;DEL;22869663;34801031;CNV;11931368
15;;N;DEL;34860448;37375606;CNV;2515158
15;;N;DEL;45643557;46824898;CNV;1181341
15;;N;DEL;53024290;56782555;CNV;3758265
15;;N;DUP;82778879;86043105;CNV;3264226
15;;N;DUP;87932658;93365980;CNV;5433322
16;;N;DUP;215160;5937350;CNV;5722190
16;;N;DUP;19200609;59696833;CNV;40496224
16;;N;DUP;65251276;72437085;CNV;7185809
16;;N;DUP;72612050;83453711;CNV;10841661
17;;N;DUP;27409092;29771201;CNV;2362109
17;;N;DUP;35546753;37232010;CNV;1685257
17;;N;DUP;37529428;47018312;CNV;9488884
17;;N;DEL;51511372;54447260;CNV;2935888
18;;N;DEL;1570336;2683445;CNV;1113109
18;;N;DEL;25847680;31330652;CNV;5482972
18;;N;DEL;36676705;43518291;CNV;6841586
18;;N;DEL;43519205;51368455;CNV;7849250
18;;N;DEL;51380099;54976368;CNV;3596269
18;;N;DEL;60191569;73835753;CNV;13644184
18;;N;DEL;76042009;76043792;CNV;1783
20;;N;DEL;6147576;8619458;CNV;2471882
20;;N;DEL;12810076;17810397;CNV;5000321
20;;N;DEL;20177123;26159564;CNV;5982441
20;;N;DUP;26219007;31259815;CNV;5040808
20;;N;DUP;33930548;35017295;CNV;1086747
20;;N;DUP;35065161;42813748;CNV;7748587
20;;N;DUP;42836502;50612277;CNV;7775775
20;;N;DUP;50824544;54388448;CNV;3563904
20;;N;DUP;55715737;61825779;CNV;6110042
21;;N;DEL;18093720;21534014;CNV;3440294
21;;N;DUP;30953046;39882530;CNV;8929484
21;;N;DUP;41263749;46680243;CNV;5416494
22;;N;DUP;15438402;20775271;CNV;5336869
22;;N;DUP;21013301;21095122;CNV;81821
22;;N;DUP;21102229;26476138;CNV;5373909
1;;N;DUP;26539197;30571250;CNV;4032053
1;;N;DEL;69144171;108015083;CNV;38870912
1;;N;DUP;108017831;110712446;CNV;2694615
1;;N;DUP;119686494;169232329;CNV;49545835
1;;N;DUP;200167454;207442593;CNV;7275139
1;;N;DUP;227818357;231401381;CNV;3583024
1;;N;DEL;231406344;231407876;CNV;1532
2;;N;DUP;86271615;114579673;CNV;28308058
3;;N;DEL;119131;2526646;CNV;2407515
3;;N;DUP;67689978;73742493;CNV;6052515
4;;N;DUP;415163;10306777;CNV;9891614
4;;N;DEL;53024188;182582458;CNV;129558270
6;;N;DUP;205610;40256529;CNV;40050919
6;;N;DUP;40356190;40358103;CNV;1913
6;;N;DUP;104895731;108039058;CNV;3143327
6;;N;DUP;119921558;120188688;CNV;267130
6;;N;DUP;149015169;150703144;CNV;1687975
6;;N;DUP;150847466;153986960;CNV;3139494
6;;N;DUP;154027674;154350643;CNV;322969
7;;N;DUP;20597415;38446969;CNV;17849554
7;;N;DUP;148239909;159262480;CNV;11022571
8;;N;DEL;2214638;28535026;CNV;26320388
8;;N;DEL;34352750;36867307;CNV;2514557
9;;N;DEL;249391;33029470;CNV;32780079
10;;N;DUP;223755;8349466;CNV;8125711
10;;N;DEL;8418928;10197423;CNV;1778495
10;;N;DUP;10254419;12840415;CNV;2585996
10;;N;DEL;12891255;12926547;CNV;35292
10;;N;DUP;13005506;14106482;CNV;1100976
10;;N;DEL;14106768;14300617;CNV;193849
10;;N;DEL;16077049;19521245;CNV;3444196
10;;N;DEL;36309499;38255991;CNV;1946492
10;;N;DEL;80787964;84704831;CNV;3916867
11;;N;DEL;6856644;9751970;CNV;2895326
11;;N;DUP;10810855;12207132;CNV;1396277
11;;N;DEL;12282453;16881127;CNV;4598674
11;;N;DEL;20679229;22371578;CNV;1692349
11;;N;DUP;22393403;23181857;CNV;788454
11;;N;DEL;27213017;31479980;CNV;4266963
11;;N;DUP;31614934;37110292;CNV;5495358
12;;N;DUP;114256;1792319;CNV;1678063
12;;N;DUP;1825754;2402145;CNV;576391
12;;N;DUP;2463370;4478433;CNV;2015063
12;;N;DUP;4882119;4962434;CNV;80315
12;;N;DUP;6775910;6776244;CNV;334
12;;N;DUP;25101642;26109493;CNV;1007851
12;;N;DUP;26120155;27469009;CNV;1348854
12;;N;DUP;27469616;29781018;CNV;2311402
12;;N;DUP;41859384;42076719;CNV;217335
12;;N;DUP;42196422;49912365;CNV;7715943
12;;N;DEL;74147931;78565647;CNV;4417716
12;;N;DUP;125703167;132924025;CNV;7220858
13;;N;DUP;18848939;40232971;CNV;21384032
13;;N;DUP;40233346;45616202;CNV;5382856
13;;N;DUP;45696465;53393956;CNV;7697491
13;;N;DUP;53402454;94052210;CNV;40649756
13;;N;DUP;94082682;114267888;CNV;20185206
15;;N;DEL;34797231;37948114;CNV;3150883
16;;N;DEL;59701433;59876571;CNV;175138
16;;N;DEL;79627600;79647470;CNV;19870
16;;N;DUP;79870132;80153477;CNV;283345
16;;N;DUP;85803818;89774300;CNV;3970482
18;;N;DEL;28637387;73930061;CNV;45292674
21;;N;DEL;10494342;24068340;CNV;13573998
21;;N;DUP;24116571;24116591;CNV;20
1;;N;DEL;68428149;107476225;CNV;39048076
1;;N;DUP;116118962;162172559;CNV;46053597
1;;N;DUP;200920705;207701830;CNV;6781125
1;;N;DEL;227056783;227057842;CNV;1059
1;;N;DUP;228090807;231401381;CNV;3310574
2;;N;DUP;116866015;133147257;CNV;16281242
3;;N;DUP;2290420;26381151;CNV;24090731
3;;N;DEL;118759426;118760179;CNV;753
3;;N;DEL;141893531;147643550;CNV;5750019
4;;N;DEL;59538762;179821892;CNV;120283130
5;;N;DUP;24552207;24913958;CNV;361751
5;;N;DUP;24922486;27260162;CNV;2337676
5;;N;DUP;27262082;29794036;CNV;2531954
5;;N;DEL;29794130;29849291;CNV;55161
5;;N;DUP;29873567;45553285;CNV;15679718
6;;N;DEL;37667157;39497137;CNV;1829980
6;;N;DUP;109797573;112455295;CNV;2657722
6;;N;DUP;112474075;119312369;CNV;6838294
6;;N;DEL;161619373;170543473;CNV;8924100
7;;N;DUP;1494152;66956156;CNV;65462004
7;;N;DEL;78467737;126818300;CNV;48350563
7;;N;DUP;135078446;135368710;CNV;290264
7;;N;DEL;135695072;157509797;CNV;21814725
8;;N;DEL;3625047;5959902;CNV;2334855
8;;N;DEL;5960606;8340709;CNV;2380103
8;;N;DEL;9203557;37023064;CNV;27819507
8;;N;DUP;37023284;38806656;CNV;1783372
8;;N;DUP;39354936;64301935;CNV;24946999
8;;N;DUP;64302562;82698146;CNV;18395584
8;;N;DUP;82775726;88099763;CNV;5324037
8;;N;DUP;89620537;123732420;CNV;34111883
8;;N;DEL;123820686;123821071;CNV;385
8;;N;DUP;123932940;142824280;CNV;18891340
9;;N;DEL;70826982;92044049;CNV;21217067
9;;N;DEL;100639656;104921355;CNV;4281699
10;;N;DUP;4222916;14083636;CNV;9860720
10;;N;DEL;50058334;56296063;CNV;6237729
11;;N;DUP;38807808;45200139;CNV;6392331
11;;N;DEL;55663054;60279937;CNV;4616883
11;;N;DUP;60294059;69462310;CNV;9168251
11;;N;DEL;74172718;110124562;CNV;35951844
11;;N;DUP;133607700;134707739;CNV;1100039
12;;N;DUP;114256;3733023;CNV;3618767
12;;N;DUP;10243929;12678404;CNV;2434475
13;;N;DUP;29918080;96745125;CNV;66827045
14;;N;DEL;79046830;88959564;CNV;9912734
15;;N;DEL;34860448;37948114;CNV;3087666
15;;N;DEL;53024290;53766314;CNV;742024
16;;N;DUP;215160;89774300;CNV;89559140
17;;N;DUP;42993510;44770726;CNV;1777216
17;;N;DEL;51663781;54447260;CNV;2783479
18;;N;DEL;159885;54166542;CNV;54006657
18;;N;DEL;54199034;59718725;CNV;5519691
18;;N;DEL;59785871;73836155;CNV;14050284
18;;N;DEL;73853163;75977771;CNV;2124608
20;;N;DUP;167044;6441354;CNV;6274310
20;;N;DUP;6441923;8619458;CNV;2177535
20;;N;DUP;8646662;10499137;CNV;1852475
20;;N;DEL;13257067;15270385;CNV;2013318
20;;N;DUP;24797819;25068304;CNV;270485
20;;N;DUP;25068647;33222046;CNV;8153399
20;;N;DUP;33930548;35142661;CNV;1212113
20;;N;DUP;35471850;36381548;CNV;909698
20;;N;DUP;37185111;37617885;CNV;432774
20;;N;DUP;42716149;43579005;CNV;862856
20;;N;DUP;43584147;44045208;CNV;461061
20;;N;DUP;44466857;47008524;CNV;2541667
20;;N;DUP;47044945;54639706;CNV;7594761
20;;N;DEL;54703182;57015242;CNV;2312060
20;;N;DUP;57015473;59455997;CNV;2440524
21;;N;DEL;10494342;18685360;CNV;8191018
21;;N;DEL;18694386;20669634;CNV;1975248
21;;N;DEL;20672024;30787962;CNV;10115938
1;;N;DUP;118523535;119594822;CNV;1071287
1;;N;DUP;119686494;169101094;CNV;49414600
1;;N;DUP;174457318;185564770;CNV;11107452
1;;N;DUP;199159590;248655165;CNV;49495575
4;;N;DUP;415163;7782467;CNV;7367304
4;;N;DUP;64463647;64885548;CNV;421901
6;;N;DUP;40356190;40490820;CNV;134630
7;;N;DUP;126638731;126640156;CNV;1425
8;;N;DUP;240568;2215736;CNV;1975168
8;;N;DEL;2498001;8340709;CNV;5842708
8;;N;DUP;8361833;9190594;CNV;828761
11;;N;DUP;60655418;74104894;CNV;13449476
12;;N;DEL;114086628;115135098;CNV;1048470
16;;N;DUP;215160;51528619;CNV;51313459
16;;N;DUP;56065020;59696833;CNV;3631813
17;;N;DUP;38765943;40981473;CNV;2215530
17;;N;DUP;41001135;51142086;CNV;10140951
17;;N;DEL;52175037;54447260;CNV;2272223
20;;N;DUP;8489282;64240906;CNV;55751624
3;;N;DEL;1208626;1899238;CNV;690612
4;;N;DUP;3034903;9606465;CNV;6571562
6;;N;DEL;53984651;54059899;CNV;75248
6;;N;DEL;66202173;66417061;CNV;214888
6;;N;DUP;94446537;94446736;CNV;199
7;;N;DUP;1494152;3380318;CNV;1886166
8;;N;DEL;82656105;83820269;CNV;1164164
8;;N;DEL;88195351;89760776;CNV;1565425
11;;N;DUP;8783714;13907288;CNV;5123574
12;;N;DEL;23624486;24708242;CNV;1083756
12;;N;DUP;30258366;33163183;CNV;2904817
16;;N;DUP;8398638;12526972;CNV;4128334
18;;N;DEL;49850484;80087573;CNV;30237089
20;;N;DUP;58556863;59025600;CNV;468737
1;;N;DUP;911484;18476528;CNV;17565044
1;;N;DEL;60143371;69144171;CNV;9000800
1;;N;DEL;69193736;101130492;CNV;31936756
2;;N;DUP;124279347;124396757;CNV;117410
2;;N;DEL;124422177;165305438;CNV;40883261
2;;N;DUP;172843389;178308954;CNV;5465565
3;;N;DEL;119131;26927397;CNV;26808266
3;;N;DEL;61964465;62127387;CNV;162922
3;;N;DEL;80550607;80958514;CNV;407907
3;;N;DUP;80996989;89913897;CNV;8916908
4;;N;DEL;10338862;117528307;CNV;107189445
4;;N;DEL;118978584;189795030;CNV;70816446
5;;N;DUP;207389;18469349;CNV;18261960
5;;N;DUP;18713443;31284166;CNV;12570723
5;;N;DUP;31317387;38417737;CNV;7100350
5;;N;DEL;168322873;168323042;CNV;169
5;;N;DUP;168328981;180644249;CNV;12315268
6;;N;DEL;116276561;116277312;CNV;751
7;;N;DEL;26745261;26745907;CNV;646
7;;N;DUP;106719963;108332853;CNV;1612890
8;;N;DEL;2214638;3790798;CNV;1576160
8;;N;DEL;3808463;5960606;CNV;2152143
8;;N;DEL;5963363;37023284;CNV;31059921
8;;N;DUP;37069431;39354936;CNV;2285505
8;;N;DEL;39745545;52142793;CNV;12397248
8;;N;DUP;52184358;53587943;CNV;1403585
8;;N;DEL;54049835;60183541;CNV;6133706
8;;N;DUP;95288847;131070505;CNV;35781658
8;;N;DEL;131141156;142824280;CNV;11683124
10;;N;DUP;223755;44207480;CNV;43983725
10;;N;DEL;44217737;48435183;CNV;4217446
10;;N;DEL;48901178;52826288;CNV;3925110
11;;N;DUP;1961088;3943494;CNV;1982406
11;;N;DUP;20083123;20661604;CNV;578481
11;;N;DUP;31614934;37029137;CNV;5414203
11;;N;DUP;40246547;40255175;CNV;8628
11;;N;DEL;56399610;63096532;CNV;6696922
11;;N;DEL;71307043;131522794;CNV;60215751
12;;N;DUP;10180748;12404666;CNV;2223918
12;;N;DUP;24708099;33117978;CNV;8409879
12;;N;DUP;110842800;132924025;CNV;22081225
13;;N;DUP;20468947;24196963;CNV;3728016
13;;N;DEL;24197026;24197747;CNV;721
13;;N;DUP;24220081;26296618;CNV;2076537
13;;N;DUP;26326783;37233194;CNV;10906411
13;;N;DUP;47854380;68778142;CNV;20923762
13;;N;DUP;68850619;114267888;CNV;45417269
14;;N;DEL;62373517;62874078;CNV;500561
14;;N;DEL;78626542;98224057;CNV;19597515
15;;N;DEL;22867864;53561134;CNV;30693270
15;;N;DEL;55620677;86790950;CNV;31170273
16;;N;DUP;26758807;29644889;CNV;2886082
17;;N;DUP;40966545;51949882;CNV;10983337
20;;N;DEL;167044;18694836;CNV;18527792
20;;N;DUP;18723723;64240906;CNV;45517183
21;;N;DEL;27971084;27988400;CNV;17316
1;;N;DEL;911484;48998995;CNV;48087511
1;;N;DEL;49000343;49296746;CNV;296403
1;;N;DEL;49363924;68966361;CNV;19602437
1;;N;DEL;69144171;83759849;CNV;14615678
1;;N;DEL;83761083;119594822;CNV;35833739
1;;N;DUP;144009019;169743456;CNV;25734437
1;;N;DUP;228126990;236131776;CNV;8004786
2;;N;DUP;110819;3844202;CNV;3733383
2;;N;DUP;173871859;173982965;CNV;111106
2;;N;DUP;198273133;208948606;CNV;10675473
2;;N;DUP;216096798;240942225;CNV;24845427
4;;N;DEL;415163;2510736;CNV;2095573
4;;N;DEL;2569969;2805182;CNV;235213
4;;N;DEL;7949410;37360520;CNV;29411110
4;;N;DEL;37367582;39121077;CNV;1753495
4;;N;DUP;39159614;39457534;CNV;297920
4;;N;DEL;39746903;42746928;CNV;3000025
4;;N;DEL;42799302;46980417;CNV;4181115
4;;N;DEL;90475154;92588008;CNV;2112854
4;;N;DUP;92725350;92739807;CNV;14457
4;;N;DUP;124731724;124782850;CNV;51126
4;;N;DEL;166287307;179748265;CNV;13460958
4;;N;DEL;179798225;189795030;CNV;9996805
5;;N;DEL;18713443;31283313;CNV;12569870
5;;N;DEL;103518124;107458282;CNV;3940158
6;;N;DUP;205610;56927778;CNV;56722168
6;;N;DUP;124492075;170543473;CNV;46051398
7;;N;DUP;22499245;28436894;CNV;5937649
7;;N;DEL;28451046;28577012;CNV;125966
7;;N;DUP;28746353;38547372;CNV;9801019
8;;N;DEL;471777;3811414;CNV;3339637
8;;N;DUP;3958599;4704411;CNV;745812
8;;N;DUP;4781184;4899862;CNV;118678
8;;N;DUP;5410846;5914005;CNV;503159
8;;N;DEL;5934861;5935926;CNV;1065
8;;N;DEL;6095422;30320453;CNV;24225031
8;;N;DUP;30353003;31385051;CNV;1032048
8;;N;DEL;31391190;41858845;CNV;10467655
10;;N;DEL;50645266;67966330;CNV;17321064
11;;N;DEL;4933312;4959451;CNV;26139
11;;N;DEL;20679229;56652553;CNV;35973324
11;;N;DUP;77218062;134707739;CNV;57489677
12;;N;DUP;114256;16806210;CNV;16691954
12;;N;DUP;16971111;24782758;CNV;7811647
12;;N;DUP;26444100;33163183;CNV;6719083
13;;N;DUP;18848939;53402639;CNV;34553700
13;;N;DUP;53412021;67174710;CNV;13762689
13;;N;DUP;67207096;85666354;CNV;18459258
13;;N;DUP;85666568;89821719;CNV;4155151
13;;N;DUP;89866610;114267888;CNV;24401278
14;;N;DEL;78976953;87952898;CNV;8975945
17;;N;DEL;601219;21030442;CNV;20429223
20;;N;DUP;15274043;25526859;CNV;10252816
20;;N;DEL;26159564;26227269;CNV;67705
7;;N;DEL;57428891;63375308;CNV;5946417
7;;N;DUP;90694383;90760331;CNV;65948
8;;N;DEL;88889108;89621096;CNV;731988
10;;N;DEL;28738004;28739607;CNV;1603
15;;N;DUP;20743076;22199721;CNV;1456645
16;;N;DUP;215160;2897013;CNV;2681853
